1235  RT	slang
194   lt	link
121   #bpt112	hash_tag
119   gt	link
117   ne	slang; spell:eine:deletion
108   xD	smiley
97    #wettendass	hash_tag
73    is	fw
60    #ff	hash_tag
60    grad	 spell:gerade:deletion; slang
53    Gottschalk	ne:person
53    haha	inj
50    nich	 spell:nicht:deletion; slang
47    nen	slang; spell:einen:deletion
41    Stardoll	ne:company
40    gepostet	loan
39    #offenbings	hash_tag
36    Tweets	loan
35    XD	smiley
34    nix	slang; spell:nichts:substitution/deletion
32    Na	inj
32    유	fw
31    @OMGermanTeen	at_token
30    ok	inj
30    sowas	dict
29    Haha	inj
29    naja	inj; spell:na ja:deletion
28    lol	 slang; inj
26    :-D	smiley
26    heut	spell:heute:deletion; slang
26    net	spell:nicht:substitution/deletion; slang
26    wär	 spell:wäre:deletion; slang
25    The	fw
25    erstmal	dict
25    gibts	spell:gibt es:deletion; slang
24    #OMGermanTeen	hash_tag
24    fuer	umlaut
24    gehts	 spell:geht es:deletion; slang
23    #Offenbings	hash_tag
23    na	inj
22    Guttenberg	ne:person
22    freu	spell:freue:deletion; slang
21    find	spell:finde:deletion; slang
21    nem	 spell:einem:deletion; slang
20    on	fw
20    weiss	dict
19    @ZDFonline	at_token
19    Jauch	ne:person
19    nacht	dict
19    werd	spell:werde:deletion; slang
18    Naja	inj
18    Tweet	loan
18    grade	spell:gerade:deletion; slang
18    iPhone	ne:product
17    #WettenDass	hash_tag
17    #fb	hash_tag
17    @youtube	at_token
17    sorry	 fw; inj
17    twitter	ne:company
16    #BGE	hash_tag
16    @Bushido78	at_token
16    BGE	abbr
16    Germany	fw
16    Ok	inj
16    Sorry	 fw; inj
16    di	fw
16    kenn	spell:kenne:deletion; slang
16    rum	spell:herum:deletion; slang
16    video	dict
16    würd	 spell:würde:deletion; slang
15    @FuckYesGerman	at_token
15    App	loan
15    EUR	abbr
15    German	fw
15    Social	loan
15    abend	dict
15    ey	inj
15    htt	link
15    ner	 spell:einer:deletion; slang
15    to	fw
14    #piraten	hash_tag
14    #tvprogramm	hash_tag
14    @StadtpolizeiZH	at_token
14    DJ	loan
14    OMG	abbr
14    Re	slang
14    tweets	loan
13    #bpt11	hash_tag
13    Hey	inj
13    SMS	neologism
13    Schweiger	ne:person
13    for	fw
13    geld	dict
13    twittern	neologism
13    xDD	smiley
13    zuhause	spell:zu Hause:deletion/substitution
12    Black	fw
12    DTN	abbr
12    FB	 ne:company; abbr
12    Jungs	slang
12    Spass	dict
12    TL	abbr
12    co	link
12    fur	spell:für:substitution
12    hahaha	inj
12    hehe	inj
12    jaa	 elongation; inj
12    leute	dict
12    ma	spell:mal:deletion; slang
12    min	abbr
12    tag	dict
11    @damitdasklaas	at_token
11    Nowitzki	ne:person
11    Nö	slang
11    Pageballs	ne:company
11    Stream	loan
11    at	fw
11    bild	dict
11    cont	fw
11    handy	dict
11    hey	inj
11    my	fw
11    soo	elongation
10    #mmt28	hash_tag
10    #nowplaying	hash_tag
10    #seo	hash_tag
10    #stapo24	hash_tag
10    Ey	inj
10    Galaxy	ne:product
10    Game	fw
10    Gladbach	ne:geo
10    HANSGROHE	ne:company
10    Happy	fw
10    Lol	 slang; inj
10    cc	slang
10    geb	abbr
10    hPa	abbr
10    habs	 spell:habe es:deletion; slang
10    la	fw
10    posten	loan
10    wars	 spell:war es:deletion; slang
10    ªќ	fw
9     #BPT112	hash_tag
9     #Domian	hash_tag
9     #Guttenberg	hash_tag
9     #Quoka	hash_tag
9     #fail	hash_tag
9     #hach	hash_tag
9     @pageballs_com	at_token
9     Ah	inj
9     Blu	ne:product
9     DD	abbr
9     Reus	ne:person
9     Timeline	loan
9     aku	 abbr; slang
9     daß	dict
9     facebook	ne:company
9     ga	fw
9     garnicht	spell:gar nicht:deletion
9     glück	dict
9     iOS	ne:product
9     iPad	ne:product
9     it	fw
9     lust	dict
9     markt.	token
9     much	fw
9     ned	spell:nicht:substitution,deletion; slang
9     nee	slang
9     nö	slang
9     oO	smiley
9     scho	spell:schon:deletion
9     wow	inj
9     youtube	ne:company
8     #news	hash_tag
8     @bangpowwww	at_token
8     @holgi	at_token
8     @sueddeutschede	at_token
8     Day	fw
8     HS	abbr
8     Hbf	abbr
8     Is	fw
8     Justin	ne:person
8     MP3	abbr
8     Night	fw
8     Shirt	loan
8     Til	ne:person
8     WE	abbr
8     Weihnachts	token
8     Weiss	dict
8     and	fw
8     by	fw
8     ch	link
8     film	dict
8     ht	link
8     jahre	dict
8     leid	dict
8     like	fw
8     mann	dict
8     muß	dict
8     of	fw
8     omg	abbr
8     ppm	abbr
8     son	spell:so ein:deletion
8     sooo	elongation
8     tweet	neologism
8     typ	dict
8     wa	spell:wir:substitution/deletion; slang
8     welt	dict
8     yg	fw
8     you	fw
7     #alverde	hash_tag
7     #berlin	hash_tag
7     #domian	hash_tag
7     @Sunnypedia1987	at_token
7     @hex2	at_token
7     Bonds	dict
7     Chihuahua	dict
7     Christmas	fw
7     Gottschalks	ne:person
7     Jaa	 elongation; inj
7     LOL	 slang; inj
7     Let	fw
7     Like	fw
7     Maffay	ne:person
7     Mario	ne:person
7     Min	abbr
7     Nee	slang
7     Now	fw
7     ON	fw
7     Och	inj
7     One	fw
7     Receiver	loan
7     Red	fw
7     Sky	ne:company
7     Sowas	dict
7     St	abbr
7     Titten	slang
7     Twitterer	neologism
7     Weltcup	loan
7     Zo	slang
7     Zwickauer	ne:geo
7     aww	inj
7     bekomm	spell:bekomme:deletion
7     bett	dict
7     boah	inj
7     dpa	abbr
7     dr	spell:dran:deletion
7     etc	abbr
7     ha	inj
7     hammer	dict
7     hihi	inj
7     hmm	inj
7     immernoch	spell:immer noch:deletion
7     inkl	dict
7     isch	spell:ich:insertion; slang
7     iwie	spell:irgendwie:deletion
7     jetz	spell:jetzt:deletion
7     me	fw
7     namen	dict
7     quot	fw
7     ray	ne:person
7     schaun	 spell:schauen:deletion; slang
7     schonmal	spell:schon mal:deletion
7     show	loan
7     sry	abbr
7     tja	inj
7     twittert	neologism
7     up	fw
7     vllt	spell:vielleicht:deletion
7     vo	spell:vor:deletion
7     woche	dict
7     xx	smiley
7     Äh	inj
6     #GermanTeens	hash_tag
6     #UnderTheMistletoe	hash_tag
6     #bundesliga	hash_tag
6     #fcb	hash_tag
6     #followerpower	hash_tag
6     #wetter	hash_tag
6     #zdf	hash_tag
6     :-P	smiley
6     @EpikTweet	at_token
6     @GermanTeens	at_token
6     @Griesgraemer	at_token
6     @HerrTutorial	at_token
6     @TassadarWS	at_token
6     @TineAngel1	at_token
6     @Truemmermaedel	at_token
6     @marvinkroell	at_token
6     @oOtrinityOo	at_token
6     @sechsdreinuller	at_token
6     @swish41	at_token
6     @tazgezwitscher	at_token
6     Bah	inj
6     Biel	ne:geo
6     Breaking	fw
6     Browsergame	compound
6     Browserspiel	compound
6     Bushido	fw
6     CROCS	ne:product
6     Cayman	ne:product
6     Find	spell:finde:deletion; slang
6     Follower	loan
6     GO	fw
6     Hm	inj
6     Hot	loan
6     House	fw
6     Jorge	ne:person
6     Life	fw
6     Limmat	ne:geo
6     Löw	ne:person
6     Marco	ne:person
6     Meat	fw
6     Ne	spell:eine:deletion; slang
6     No	fw
6     Playmobil	ne:product
6     Tommy	ne:person
6     WTF	 inj; slang
6     Wow	inj
6     XDDD	smiley
6     Yeah	inj
6     aja	inj
6     aufm	dict
6     augen	dict
6     com	link
6     dapd	ne:company
6     dia	fw
6     down	fw
6     eig.	abbr
6     fan	loan
6     fuck	fw; slang
6     fühl	spell:fühle:deletion
6     gesehn	spell:gesehen:deletion; slang
6     go	fw
6     grosse	dict
6     hahah	inj
6     hm	inj
6     hunger	dict
6     hätt	spell:hätte:deletion; slang
6     ik	spell:ich:substitution/deletion; slang
6     internet	neologism
6     jaaaa	elongation
6     jahr	dict
6     meins	dict; slang
6     met	spell:mit:substitution
6     mum	slang
6     off	fw
6     problem	dict
6     retweetet	neologism
6     sendung	dict
6     soooo	elongation
6     spiel	dict
6     stunden	dict
6     the	fw
6     top	loan
6     tv	abbr
6     uhr	dict
6     wel	fw
6     wenns	spell:wenn es:deletion; slang
6     winter	dict
6     wirds	spell:wird es:deletion; slang
6     wochenende	compound
6     wünsch	spell:wünsche:deletion; slang
6     xd	smiley
5     #BVB	hash_tag
5     #FCB	hash_tag
5     #FragdieGurus	hash_tag
5     #GER	hash_tag
5     #GuruAdventskalender	hash_tag
5     #IPT110	hash_tag
5     #Newsfunk	hash_tag
5     #Voice	hash_tag
5     #bge	hash_tag
5     #buli	hash_tag
5     #deal	hash_tag
5     #effzeh	hash_tag
5     #em2012	hash_tag
5     #hertha	hash_tag
5     #heuteshow	hash_tag
5     #ipteq	hash_tag
5     #jobs	hash_tag
5     #sem	hash_tag
5     #smo	hash_tag
5     #suchmaschinenoptimierung	hash_tag
5     @AddThis	at_token
5     @Bartipapi	at_token
5     @BiancaLovesSami	at_token
5     @DifferentKev	at_token
5     @Gunnsen	at_token
5     @IPData	at_token
5     @JRehborn	at_token
5     @Kakaoherzchen	at_token
5     @Lamew00d	at_token
5     @LoveBerryx3	at_token
5     @Maxk88	at_token
5     @Polm90	at_token
5     @Schmidtlepp	at_token
5     @addthis	at_token
5     @ajityass	at_token
5     @dieternuhr	at_token
5     @dorobaer	at_token
5     @gigiii96	at_token
5     @hyperaktivraupe	at_token
5     @iFlobole	at_token
5     @missOchrasy	at_token
5     @mspro	at_token
5     @plaetzchen	at_token
5     @sat1	at_token
5     @schlenzalot	at_token
5     @thebosshoss	at_token
5     @weltonline	at_token
5     @xLadyDevilx	at_token
5     @zeitonline	at_token
5     Acer	ne:company
5     Achso	spell:ach so:deletion; inj
5     Aha	inj
5     Air	fw
5     Audio	dict
5     Avatar	ne:person
5     Axor	ne:product
5     Bieber	ne:person
5     Big	fw
5     Bio	abbr
5     Britney	ne:person
5     Cain	ne:person
5     Carrier	fw
5     Cyber	fw
5     Do	abbr
5     Fashion	fw
5     Freu	spell:freue:deletion; slang
5     Gingerbread	ne:product
5     Hach	inj
5     Hmm	inj
5     Ick	 spell:Ich:substitution; slang
5     Livestream	loan
5     Liveticker	loan
5     Loaf	ne:person
5     Map	fw
5     Minecraft	ne:product
5     Of	fw
5     On	fw
5     Oo	smiley
5     Playing	fw
5     Scheiss	spell:Scheiße:deletion; slang
5     Slim	fw
5     Special	fw
5     TT	abbr
5     Temp	abbr
5     Time	fw
5     Tja	inj
5     Up	fw
5     Voice	fw
5     WAVE	fw
5     Werd	spell:werde:deletion; slang
5     Xbox	ne:product
5     achso	spell:ach so:deletion; inj
5     ah	inj
5     ang	fw
5     app	loan
5     auto	dict
5     awesome	fw
5     awww	inj
5     bier	dict
5     blah	inj
5     blog	neologism
5     deutschland	ne:geo
5     ehm	inj
5     faven	 slang; neologism
5     fb	 ne:company; abbr
5     fehler	dict
5     ff	abbr
5     finds	fw
5     freundin	dict
5     getwittert	neologism
5     gg	 smiley; inj
5     good	fw
5     gott	dict
5     gÃ¼nstigsten	dict
5     happy	fw
5     hats	 spell:hat es:deletion; slang
5     ichs	 spell:ich es:deletion; slang
5     jaja	inj
5     joa	inj
5     ju	inj
5     jz	 spell:jetzt:deletion; slang
5     ka	fw
5     komt	spell:kommt:deletion
5     krieg	dict
5     leren	fw
5     les	 spell:lese:deletion; slang
5     life	fw
5     moechte	umlaut
5     name	dict
5     nehm	spell:nehme:deletion; slang
5     nerv	spell:nerve:deletion; slang
5     no	fw
5     nog	spell:noch:substitution
5     papa	dict
5     prÃ¼fen	dict
5     retweeten	neologism
5     satz	dict
5     schatz	dict
5     schlaf	spell:schlafe:deletion; dict
5     se	 spell:sie:deletion; slang
5     seh	spell:sehe:deletion; slang
5     sitz	spell:sitze:deletion; slang
5     spaß	dict
5     stunde	dict
5     thema	dict
5     tá	fw
5     un	spell:und:deletion
5     waere	umlaut
5     we	fw
5     weisst	dict
5     wochen	dict
5     wärs	 spell:wäre es:deletion; slang
5     zo	slang
5     zuviel	spell:zu viel:deletion; dict
4     #BR	hash_tag
4     #FQ	hash_tag
4     #Gottschalk	hash_tag
4     #IPTFFFFFF	hash_tag
4     #Ribéry	hash_tag
4     #SSNHD	hash_tag
4     #SocialMedia	hash_tag
4     #Tweetkalender	hash_tag
4     #evmakir	hash_tag
4     #hamburg	hash_tag
4     #köln	hash_tag
4     #leipzig	hash_tag
4     #quoka	hash_tag
4     #spaeter	hash_tag
4     #twikolaus	hash_tag
4     #unwiderstehl	hash_tag
4     #voice	hash_tag
4     @BrokenSavior	at_token
4     @CaptOrwell	at_token
4     @ChaskaBorek	at_token
4     @DerWachsame	at_token
4     @DerWesten	at_token
4     @GermanTeenie	at_token
4     @Gronkh	at_token
4     @HausOfKate	at_token
4     @JanaEgaal	at_token
4     @KGeni	at_token
4     @Klarawrrr	at_token
4     @Lalilein_	at_token
4     @Liiseeeee	at_token
4     @MannVomTheater	at_token
4     @McDenno	at_token
4     @Muaxim	at_token
4     @SwieSuperstar	at_token
4     @TaMMy_KeKs	at_token
4     @TiiaAurora	at_token
4     @Tobi7889	at_token
4     @Turtilie	at_token
4     @YourMomma_	at_token
4     @_Rya_	at_token
4     @allestutti	at_token
4     @fefesblog	at_token
4     @fhmaster0801	at_token
4     @fred_zwitschert	at_token
4     @germanborder	at_token
4     @germanpsycho	at_token
4     @hi_d_11e	at_token
4     @hmdeutschland	at_token
4     @itChhii	at_token
4     @mchlpchl	at_token
4     @nati0n	at_token
4     @satriyowijoyo	at_token
4     @siggismallz	at_token
4     @svennibenni_de	at_token
4     @teufelsweiblein	at_token
4     @thumbsupharry	at_token
4     @xLovatoBucks	at_token
4     @xavic_fcb	at_token
4     @zeitonline_pol	at_token
4     Ali	ne:person
4     Alina	ne:person
4     Android	ne:product
4     Ardian	ne:person
4     BPT	abbr
4     Bag	fw
4     Best	fw
4     Blitzer	slang
4     Boah	inj
4     Boe	dict
4     Borussen	ne:person
4     Bujupi	ne:person
4     Bullshit	loan; slang
4     Bye	 fw; inj
4     CS	abbr; fw; ne:product
4     Camera	ne:product
4     Cap	ne:product
4     Case	loan
4     Community	loan
4     Cup	loan
4     DDD	smiley
4     DS	abbr; ne:product
4     DSDS	abbr
4     Dan	ne:person
4     Dance	loan
4     Danisch	spell:Dänisch:substitution
4     Dez	abbr
4     Elstner	ne:person
4     Fantasy	fw
4     Faymann	ne:person
4     Friends	fw
4     Girls	fw
4     Good	fw
4     Guess	fw
4     HH	abbr
4     Hahahaha	inj
4     High	loan
4     Hihi	inj
4     Hmmm	inj
4     ID	abbr
4     Ice	fw
4     Kate	ne:person
4     Kindle	ne:product
4     LOVE	loan
4     Lan	abbr
4     Lopes	ne:person
4     Love	loan
4     Luftfeuchte	compound
4     MP	abbr
4     Make	fw
4     Mathe	slang
4     Mike	ne:person
4     Model	loan
4     My	fw
4     NBA	ne:company
4     OF	fw
4     Oha	inj
4     Ohh	inj
4     Open	fw
4     Path	fw
4     Play	fw
4     Podcast	loan
4     Promo	slang; neologism
4     Purple	fw
4     Read	fw
4     Rewe	ne:company
4     Ryanair	ne:company
4     Salzungen	ne:geo
4     Schoko	token
4     Schwдnze	spell:Schwänze:substitution
4     Shit	 fw;  slang; inj
4     Skype	ne:product
4     Smartphone	neologism
4     Snoep	fw
4     South	fw
4     Spongebob	ne:person
4     Steinbrück	ne:person
4     Store	fw
4     Style	fw
4     Tablet	neologism
4     Tach	 spell:Tag:substitution; slang
4     ThyssenKrupp	ne:company
4     Till	fw
4     To	fw
4     Touch	ne:product
4     Ui	inj
4     Vegas	ne:geo
4     Winehouse	ne:person
4     With	fw
4     af	fw
4     ahnung	dict
4     amp	fw
4     arbeit	dict
4     bayern	ne:geo
4     berlin	ne:geo
4     bescheid	dict
4     bruder	dict
4     buch	dict
4     bye	fw; inj
4     check	loan
4     christmas	fw
4     dacht	spell:dachte:deletion
4     dat	spell:das:substitution; slang
4     design	loan
4     dong	fw; inj
4     duerfen	umlaut
4     dung	fw; inj
4     ebook	neologism
4     eig	abbr
4     en	fw
4     entfolgen	neologism
4     fall	dict
4     foto	dict
4     friedrichshafen	ne:geo
4     gaat	fw
4     gräber	dict
4     gw	fw
4     haare	dict
4     haus	dict
4     he	inj
4     heisse	dict
4     iPod	ne:product
4     ic	spell:ich:deletion
4     idee	dict
4     jaaa	elongation; inj
4     jij	inj
4     justin	ne:person
4     kk	abbr; slang
4     kmh	abbr
4     kok	fw
4     lagi	fw
4     leuk	fw
4     lied	dict
4     liked	fw
4     love	loan
4     mau	fw
4     max	ne:person
4     mensch	dict
4     menschen	dict
4     mitte	dict
4     montag	dict
4     nu	spell:nun:deletion; slang
4     out	fw
4     party	loan
4     pc	neologism
4     piraten	dict; ne:company
4     response	fw
4     riesenehre	compound
4     rofl	abbr
4     scheiss	spell:scheiß:substitution; slang
4     seite	dict
4     sex	dict
4     shoppen	loan
4     si	fw
4     spass	spell:Spaß:substitution; dict
4     stadt	dict
4     süsse	spell:süße:substitution/insertion; dict
4     tau	fw
4     thx	slang; inj
4     tommys	ne:person
4     twitterst	neologism
4     uuml	fw
4     ve	fw
4     very	fw
4     videos	dict
4     vorallem	spell:vor allem:deletion
4     week	fw
4     weihnachten	dict
4     weils	 spell:weil es:deletion; slang
4     xDDD	smiley
4     ya	inj
4     yeah	inj
4     zb	abbr
4     zocken	dict
4     zuviele	spell:zu viele:deletion; dict
4     ähm	inj
3     #Android	hash_tag
3     #FollowFriday	hash_tag
3     #Sat1	hash_tag
3     #Skyrim	hash_tag
3     #TheDome	hash_tag
3     #ZDFinfo	hash_tag
3     #bvb	hash_tag
3     #ch	hash_tag
3     #gottschalk	hash_tag
3     #gÃ¼nstigsten	hash_tag
3     #haushaltsaufloesung	hash_tag
3     #iTunes	hash_tag
3     #jobsuche	hash_tag
3     #knp	hash_tag
3     #musik	hash_tag
3     #münchen	hash_tag
3     #no_add	hash_tag
3     #philosophy	hash_tag
3     #phoenix	hash_tag
3     #rtl	hash_tag
3     #spd	hash_tag
3     #stellenangebote	hash_tag
3     #szonline	hash_tag
3     #taz	hash_tag
3     #teamfollowback	hash_tag
3     #trends	hash_tag
3     #twoff	hash_tag
3     @Aimar_HH	at_token
3     @AkalineableYT	at_token
3     @Annika_K	at_token
3     @ArminWolf	at_token
3     @BTRCrewGermany	at_token
3     @Belibaa_	at_token
3     @BenniferRostock	at_token
3     @BennysGirl_xoxo	at_token
3     @Brainvibes	at_token
3     @BrowserSpiele1	at_token
3     @ChibixYume	at_token
3     @DementiusPrea	at_token
3     @DerTypAusFF	at_token
3     @DoroBaer	at_token
3     @Dschavar	at_token
3     @EternalReplica	at_token
3     @EtienneToGo	at_token
3     @FabianFabsen	at_token
3     @FairyOnClouds	at_token
3     @Fanti2412	at_token
3     @GJGBTL231	at_token
3     @GebbiGibson	at_token
3     @GloriaRei	at_token
3     @GoettinHH	at_token
3     @GreenEyedNeko	at_token
3     @HaifischInAspik	at_token
3     @HannahBeitzer	at_token
3     @HerrVanBohm	at_token
3     @HoneyballCookie	at_token
3     @Huldaswift	at_token
3     @JMarkMueller	at_token
3     @Jaaaamiee	at_token
3     @JepicJedhead_	at_token
3     @JustiBasti	at_token
3     @KendallSCrewGer	at_token
3     @KonstantinNotz	at_token
3     @Lisawr	at_token
3     @MarvinDings	at_token
3     @MichelleundDu	at_token
3     @MissChessie	at_token
3     @NourAssahub	at_token
3     @Ondyi	at_token
3     @PiratenStream	at_token
3     @PlayStationDE	at_token
3     @Point1a	at_token
3     @ProSieben	at_token
3     @Qype	at_token
3     @RealDeuterium	at_token
3     @Scherzinfarkt	at_token
3     @Schnupsi407	at_token
3     @SebJabbusch	at_token
3     @SelenasMiracle	at_token
3     @Sintaura	at_token
3     @Stief1996	at_token
3     @SusanneKuenzel	at_token
3     @Teufelsweiblein	at_token
3     @ThomasMielke	at_token
3     @Thomy_Freaky	at_token
3     @TylerTroublez	at_token
3     @ViviSkarsgard	at_token
3     @WernerFailmann	at_token
3     @YLTTM	at_token
3     @__Kimba__	at_token
3     @albtraeumchen	at_token
3     @annafrOst	at_token
3     @blastactionhero	at_token
3     @brennooth	at_token
3     @bretzelmann	at_token
3     @caschy	at_token
3     @co_ki_net	at_token
3     @davidaguirre	at_token
3     @daysofmusic	at_token
3     @desasterkind	at_token
3     @deuxcvsix	at_token
3     @drPfarrer	at_token
3     @eingenickt	at_token
3     @ekelias	at_token
3     @emtiu	at_token
3     @ennomane	at_token
3     @fckoeln	at_token
3     @fortunafan95ole	at_token
3     @frankfeil	at_token
3     @gillyberlin	at_token
3     @glitter_m0nster	at_token
3     @heckyeahsaade	at_token
3     @heeeeenni	at_token
3     @heiseonline	at_token
3     @hoerns	at_token
3     @hollywhaaat	at_token
3     @iFlamongo	at_token
3     @iJol_	at_token
3     @iNerdSelena	at_token
3     @iiLoveKB	at_token
3     @intelligenceMRR	at_token
3     @justinbieber	at_token
3     @largewhiteguy	at_token
3     @mac_monday	at_token
3     @mbrandhu	at_token
3     @miinaaa	at_token
3     @ncisgirl95	at_token
3     @nedo04	at_token
3     @niels_k	at_token
3     @nzz	at_token
3     @ohaimareiki	at_token
3     @pyth2_0	at_token
3     @quantatheist	at_token
3     @rkwilde99	at_token
3     @roadrunner1904	at_token
3     @saebenerstr	at_token
3     @schwarzblond	at_token
3     @schwarzmaler20	at_token
3     @seelengebunden_	at_token
3     @sinnundverstand	at_token
3     @sixtus	at_token
3     @stadtpolizeizh	at_token
3     @tagesschau	at_token
3     @termfrequenz	at_token
3     @textzicke	at_token
3     @thatsHepHapbaby	at_token
3     @tirsales	at_token
3     @traumdenker	at_token
3     @unhappy_dream	at_token
3     @webrebell	at_token
3     @werkarniggel	at_token
3     @yaassuuu	at_token
3     @zdfonline	at_token
3     @zynaesthesie	at_token
3     ABBA	ne:company
3     Achja	spell:ach ja:substitution; inj
3     Amy	ne:person
3     Assassin	ne:product
3     Atomic	fw
3     Aw	abbr
3     BE	fw
3     BVB	abbr; ne:company
3     Bandana	dict
3     Barth	ne:person
3     Beat	loan
3     BenQ	ne:product
3     Berben	ne:person
3     Birthday	fw
3     Bo	ne:person
3     Books	fw
3     Bravo	ne:product
3     Buys	fw
3     CELAC	abbr
3     Canvas	loan
3     Carrerabahn	compound
3     Channel	loan
3     Chili	dict
3     Chris	ne:person
3     Chuck	ne:person
3     Coral	ne:geo
3     Creed	ne:product
3     DGAP	abbr
3     Dark	fw
3     Date	loan
3     Dax	ne:company
3     December	fw
3     Despres	ne:person
3     Di	fw
3     Duma	fw
3     EIL	abbr
3     El	fw
3     Email	neologism
3     End	fw
3     Entertainment	fw
3     Escort	loan
3     European	ne:company
3     FFM	abbr
3     FML	abbr
3     Fahrplanwechsel	compound
3     Feng	fw
3     Flavonmax	ne:company
3     For	fw
3     Free	fw
3     Friday	fw
3     Fuck	 fw; slang
3     GT	link
3     Ga	fw
3     Games	fw
3     Girl	fw
3     Gr.	abbr
3     Green	fw
3     Grüsse	spell:Grüße:substitution; dict
3     HTC	abbr; ne:company
3     Hahaha	inj
3     Hanke	ne:person
3     Hannah	ne:person
3     Hashtag	neologism
3     Headset	loan
3     Heels	loan
3     Hellboy	ne:person
3     Hetero	dict
3     HiFi	abbr; fw
3     Hidden	fw
3     Hobbies	dict
3     Hoffenheim	ne:geo
3     Hunziker	ne:person
3     Husky	dict
3     IMG	abbr; fw
3     Ih	inj
3     Jared	ne:person
3     Jessica	ne:person
3     Juhu	inj
3     Jupp	ne:person
3     Ka	ne:person
3     Keep	fw
3     Keramag	ne:product
3     Key	fw
3     Keys	fw
3     Kids	loan
3     Kindervon	spell:Kinder von:deletion
3     Klaas	ne:person
3     Kombo	slang
3     Krupp	ne:company
3     LG	slang
3     LV	abbr
3     La	fw
3     Labbadia	ne:person
3     Label	loan
3     Lattek	ne:person
3     League	fw
3     Lichterkette	compound
3     Lopez	ne:person
3     Lu	ne:person; ne:geo
3     Ma	abbr
3     MacBook	ne:product
3     Maejor	ne:person
3     Maps	fw
3     Maroon	ne:company
3     Mas	fw
3     Mascara	ne:product
3     Mate	ne:product
3     Michelle	ne:person
3     Muhammad	ne:person
3     Multiplayer	loan
3     NW	abbr
3     Nachti	 spell:Nacht:insertion; slang
3     Newsletter	 loan
3     Nexus	ne:product
3     Nick	ne:person
3     Nike	ne:product
3     Nix	spell:nichts:substitution/deletion; slang
3     Norris	ne:person
3     OK	inj
3     Ohhh	inj
3     PA	fw
3     PM	abbr
3     Palace	fw
3     Paradise	fw
3     Payne	ne:person
3     Pechstein	ne:person
3     Perry	ne:person
3     Phoenix	ne:company
3     Plait	ne:product
3     Please	 inj; fw
3     Pocket	fw
3     Podolski	ne:person
3     Prelaunch	loan
3     Primera	ne:company; ne:product
3     Proble	spell:Probleme:deletion
3     Promi	slang
3     PunktenIch	spell:Punkten Ich:deletion
3     Puzzlepaneelen	compound
3     RP	abbr
3     Ray	ne:person
3     Resistance	fw; ne:product
3     Retweet	slang
3     Rex	ne:person; ne:product
3     Rinderschocker	compound
3     Ruhl	ne:geo
3     SC	spell:schwerer:deletion
3     SEO	abbr; fw
3     SF	abbr
3     SG	abbr
3     SSL	abbr
3     ST	abbr
3     SVP	abbr
3     SW	abbr
3     Saar	ne:geo
3     Saints	ne:product
3     Sander	ne:person
3     Sans	fw
3     Sarah	ne:person
3     Sat	ne:company
3     Scheisse	spell:Scheiße:substitution; dict
3     Schmitz	ne:person
3     Schuhbeck	ne:person
3     Security	loan
3     Seller	loan
3     Share	loan
3     Shopping	loan
3     Shui	fw
3     Siri	ne:product
3     Sms	neologism
3     Sooo	elongation
3     Soundtrack	loan
3     Sry	abbr; fw
3     Starck	ne:product
3     Stick	loan
3     THE	fw
3     THQ	abbr
3     TK	abbr
3     TO	fw
3     Tab	abbr
3     Tablets	neologism
3     Taiji	ne:geo
3     Tenny	slang
3     Ticker	loan
3     Toma	ne:person
3     Tonic	dict
3     Traffic	loan
3     Tv	abbr
3     Tweetdiebstahl	compound
3     Tweetklau	compound
3     Twist	loan
3     Vinyl	dict
3     Virtual	fw
3     Vorallem	spell:vor allem:deletion; dict
3     Vorrundengegner	compound
3     We	fw
3     What	fw
3     White	fw
3     Witt	ne:person
3     Xavier	ne:person
3     YEAH	inj
3     Yay	inj
3     Yes	 inj; fw
3     account	loan
3     adden	loan
3     ahh	inj
3     aka	slang
3     akku	abbr
3     album	dict
3     alkohol	dict
3     apa	fw
3     aqui	fw
3     ard	ne:company
3     arsch	dict
3     art	dict
3     aso	spell:also:deletion
3     ausgang	dict
3     ava	slang
3     banyak	fw
3     bb	abbr
3     bella	ne:person
3     bissl	slang
3     bock	dict
3     bom	fw
3     boys	loan
3     bpt	abbr
3     bt	fw
3     buat	fw
3     bus	dict
3     bzw	dict
3     chemie	dict
3     chillin	 fw;  spell:cilling:deletion; slang
3     chrom	dict
3     couch	dict
3     crocs	ne:product
3     dad	loan; slang
3     ding	dict
3     downloaden	neologism
3     draus	spell:daraus:deletion; dict
3     ei	dict
3     eis	dict
3     entfolgst	neologism
3     erinnerungen dict
3     erlich	spell:ehrlich:deletion
3     familie	dict
3     feat	fw
3     feier	dict
3     fine	spell:finde:deletion
3     flasche	dict
3     follower	loan
3     frau	dict
3     free	fw
3     freunde	dict
3     friends	fw
3     gaaaanz	elongation
3     gaga	ne:person
3     gak	fw
3     ge	spell:gestern:deletion
3     gebloggt	neologism
3     gehn	spell:gehen:deletion
3     gitarre	dict
3     gl	abbr
3     google	ne:company
3     grossen	spell:großen:substitution/insertion; dict
3     gruppe	dict
3     habn	spell:haben:deletion; slang
3     hahahaha	inj
3     ham	spell:haben:substitution/deletion; slang
3     heissen	spell:heißen:substitution/insertion; dict
3     hi	inj
3     hilfe	dict
3     hinbekomme	dict
3     ho	inj
3     hochgeladen	dict
3     holland	ne:geo
3     home	loan
3     hust	inj
3     hät	spell:hätte:deletion
3     hö	inj
3     icq	ne:product
3     ihrs	spell:ihres:deletion; dict
3     info	dict; abbr
3     isses	spell:ist es:deletion,substitution; slang
3     jadi	fw
3     japp	inj
3     jep	inj
3     jepp	inj
3     jez	spell:jetzt:deletion
3     jo	inj
3     jojo	ne:person; ne:product
3     kacken	slang; dict
3     kaffee	dict
3     kaka	fw
3     kanns	spell:Kann es:deletion
3     karte	dict
3     katze	dict
3     ki	fw
3     lama	fw
3     langsung	fw
3     le	fw
3     leine	dict
3     lg	slang
3     lmao	slang
3     makin	fw
3     match	loan
3     mensen	dict
3     mer	 spell:mir:substitution; slang
3     mh	inj
3     mitreissen	spell:mitreißen:substitution/insertion; dict
3     mittwoch	dict
3     mom	spell:moment:deletion; slang
3     moment	dict
3     movie	fw
3     musik	dict
3     mutter	dict
3     männer	dict
3     naar	fw
3     nciht	spell:nicht:substitution
3     nd	fw
3     neet	fw
3     ni	spell:nicht:deletion; slang
3     nice	fw
3     nurnoch	spell:nur noch:deletion
3     nya	inj
3     nä	inj
3     och	inj
3     oha	inj
3     ohh	inj
3     oje	inj
3     olle	slang
3     oooh	elongation; inj
3     org	link
3     pic	fw; slang
3     pink	dict
3     pizza	dict
3     plan	dict
3     pls	 fw;  spell:please:deletion; slang
3     pp	smiley
3     present	fw
3     profil	dict
3     rauf	spell:herauf:deletion; slang
3     rauskommen	spell:herauskommen:deletion; dict; slang
3     ricardo.	token
3     right	fw
3     rüber	spell:herüber:deletion; dict; slang
3     sale	loan
3     sapa	fw
3     sau	dict
3     schatje	fw
3     schluss	dict
3     schwanz	dict
3     sic	spell:sicher:deletion
3     sis	slang
3     sorry.	token
3     standard	dict
3     star	loan
3     stehts	 spell:steht es:deletion; slang
3     stück	dict
3     sweet	loan
3     sz	abbr
3     tabletten	dict
3     tages	dict
3     test	dict
3     timeline	loan
3     tisch	dict
3     tod	dict
3     too	fw
3     träum	spell:träume:deletion; dict
3     ts	inj
3     twittere	neologism
3     tztztz	inj
3     ui	inj
3     unverbraucht	dict
3     upd	fw
3     usb	neologism
3     usw	dict
3     vem	fw
3     ver	link
3     vi	spell:viel:deletion
3     voten	loan
3     vão	fw
3     weis	spell:weiß:deletion; dict
3     weißte	spell:weißt du:deletion/insertion; slang
3     wetter	dict
3     what	fw
3     wien	ne:geo
3     wohnung	dict
3     work	fw
3     wort	dict
3     xDDDD	smiley
3     xo	smiley
3     yach	fw
3     yay	inj
3     yo	inj
3     zyn	 spell:sind:substitution,deletion; slang
3     à	fw
3     äh	inj
3     österreich	ne:geo
2     #1DonGermanTVtoday	hash_tag
2     #Adventsk	hash_tag
2     #Austria	hash_tag
2     #BPT11	hash_tag
2     #Battlefield3	hash_tag
2     #BeaverCreek	hash_tag
2     #Birkenbihl	hash_tag
2     #Castor	hash_tag
2     #Comedy	hash_tag
2     #ComedyCentral	hash_tag
2     #Crozza	hash_tag
2     #CuReSoft	hash_tag
2     #DEPR	hash_tag
2     #EinsExtra	hash_tag
2     #EinsPlus	hash_tag
2     #FCBayern	hash_tag
2     #FCK	hash_tag
2     #Fahrraeder	hash_tag
2     #Fewo	hash_tag
2     #FloraPower	hash_tag
2     #Followerpower	hash_tag
2     #Galaxy	hash_tag
2     #Germany	hash_tag
2     #Guben	hash_tag
2     #HIMYM	hash_tag
2     #Jülich	hash_tag
2     #KSC	hash_tag
2     #LastActionSEO	hash_tag
2     #MEGADOTS	hash_tag
2     #MEGATEST	hash_tag
2     #NP	hash_tag
2     #Phoenix	hash_tag
2     #Podolski	hash_tag
2     #ProSieben	hash_tag
2     #Promifunk	hash_tag
2     #SWR	hash_tag
2     #SWTOR	hash_tag
2     #Silent	hash_tag
2     #Superflat	hash_tag
2     #Twittercharts	hash_tag
2     #VOICE	hash_tag
2     #WettenDas	hash_tag
2     #adobe	hash_tag
2     #adventskalender	hash_tag
2     #afghanistan	hash_tag
2     #auslosung	hash_tag
2     #auto	hash_tag
2     #awlb	hash_tag
2     #badminton	hash_tag
2     #bcruhr5	hash_tag
2     #berli	hash_tag
2     #beuel	hash_tag
2     #bonn	hash_tag
2     #bpt	hash_tag
2     #campixx	hash_tag
2     #cop17	hash_tag
2     #derStandardNewsroom	hash_tag
2     #ek2012	hash_tag
2     #eps	hash_tag
2     #erotik	hash_tag
2     #esports	hash_tag
2     #euro2012	hash_tag
2     #fcbayern	hash_tag
2     #fcsp	hash_tag
2     #federball	hash_tag
2     #film	hash_tag
2     #fm303	hash_tag
2     #forum	hash_tag
2     #gangbang	hash_tag
2     #gebloggt	hash_tag
2     #gov20	hash_tag
2     #gov2vie	hash_tag
2     #gruene	hash_tag
2     #holzfäller	hash_tag
2     #jena	hash_tag
2     #klimawandel	hash_tag
2     #ksc	hash_tag
2     #kulturzwitscher	hash_tag
2     #ldkBB11	hash_tag
2     #markt	hash_tag
2     #mittelstand	hash_tag
2     #musseinfachmalgesagtsein	hash_tag
2     #poldi	hash_tag
2     #promojob	hash_tag
2     #rabatt	hash_tag
2     #radio	hash_tag
2     #rotblaulive	hash_tag
2     #sc12	hash_tag
2     #schlager	hash_tag
2     #simulator	hash_tag
2     #skichallenge	hash_tag
2     #skyrim	hash_tag
2     #socialmedia	hash_tag
2     #spd11	hash_tag
2     #ssnhd	hash_tag
2     #svw	hash_tag
2     #thedome	hash_tag
2     #ttms	hash_tag
2     #twa	hash_tag
2     #tweetkalender	hash_tag
2     #twexit	hash_tag
2     #twitterlauftreff	hash_tag
2     #twuenchen4	hash_tag
2     #twuizzer	hash_tag
2     #wdr	hash_tag
2     #we	hash_tag
2     #weihnachten	hash_tag
2     #wettendas	hash_tag
2     #xmas	hash_tag
2     #Ãkostromanbieter	hash_tag
2     #Ãkostromkosten	hash_tag
2     #Ãkostrompreise	hash_tag
2     @1DStreetteamGER	at_token
2     @1selina	at_token
2     @343max	at_token
2     @Afelia	at_token
2     @Aggi_2211	at_token
2     @Aha_Ein_Keks_	at_token
2     @Aitheena	at_token
2     @Alan_Berlin69	at_token
2     @AlicieLion	at_token
2     @AlinaMoehn	at_token
2     @AnEmptyPromise	at_token
2     @AndreR241	at_token
2     @AntonioGrazian	at_token
2     @Applewar	at_token
2     @ArianaBow	at_token
2     @Arrivedwithyou	at_token
2     @AthariDrawer	at_token
2     @BeautyBetty84	at_token
2     @Bers0lli	at_token
2     @BlackChester	at_token
2     @BoyItsOnlyU	at_token
2     @BringCodyToGER	at_token
2     @BugsB	at_token
2     @BunterKneten	at_token
2     @COMPUTENTsecure	at_token
2     @CanBerber	at_token
2     @Carinaaaa_	at_token
2     @Caroouuu	at_token
2     @Caros_Kaffee	at_token
2     @Chazewill	at_token
2     @ChrisPrinzMusik	at_token
2     @Chrissie_61	at_token
2     @ClaudusQa	at_token
2     @Claus_Pandi	at_token
2     @Coladewe	at_token
2     @DaKrys	at_token
2     @DanKuta	at_token
2     @DasDodo	at_token
2     @Dear_Insanity	at_token
2     @Divasmind	at_token
2     @DonnahSummer	at_token
2     @DrachenHerz	at_token
2     @DuDoooo5	at_token
2     @ESL	at_token
2     @EchelonLaura	at_token
2     @EgoTripMSR	at_token
2     @Enigma424	at_token
2     @ExMarbuergerin	at_token
2     @FabelF	at_token
2     @FabulousEsra	at_token
2     @FcZuerich1	at_token
2     @FelixBrandwein	at_token
2     @FensterRentner	at_token
2     @FineARTCologne	at_token
2     @GameWolf	at_token
2     @GermanStylators	at_token
2     @Glamnbert	at_token
2     @Glimmermaedchen	at_token
2     @Gloeckchen27	at_token
2     @GomezStew	at_token
2     @HBrunoo	at_token
2     @Habbo_Sm23	at_token
2     @HandsomeLogan	at_token
2     @HannaJulian	at_token
2     @HerrDemodex	at_token
2     @HerrIdefix	at_token
2     @Hirngestoert	at_token
2     @IJustinbieberJB	at_token
2     @IboSC2	at_token
2     @Inspiritx3	at_token
2     @JananasGold	at_token
2     @JayPlusPlus	at_token
2     @Jeff_Tichar	at_token
2     @Jemus42	at_token
2     @Jettchen88	at_token
2     @Jettlein	at_token
2     @JuliaMellark	at_token
2     @JulianDik	at_token
2     @Julysmith19	at_token
2     @JuneXOXO__	at_token
2     @JwieJaci	at_token
2     @KRABAT44	at_token
2     @KathaFreaak	at_token
2     @KephrenLIVE	at_token
2     @KevinZukerman	at_token
2     @KieBook	at_token
2     @KleeneMelle81	at_token
2     @KleinePfeife	at_token
2     @KoebesJakob	at_token
2     @Kuechendenker	at_token
2     @Ladiesfirstify	at_token
2     @LadyColonia	at_token
2     @Lake_Master	at_token
2     @Laurax3Sami	at_token
2     @Lena_HeartLeaf	at_token
2     @LesPapillions	at_token
2     @LieutenantGustl	at_token
2     @Lische_n	at_token
2     @MacSnider	at_token
2     @MakMaksan	at_token
2     @Mariella_x3	at_token
2     @Marleenx3Sami	at_token
2     @MartinBeyond	at_token
2     @Marvication	at_token
2     @McSchnitzel87	at_token
2     @Mc_Lina_	at_token
2     @MeLikeyKendall	at_token
2     @MeinJadoreYT	at_token
2     @MemiCrown	at_token
2     @MerkelsSchatten	at_token
2     @MerlinausAvalon	at_token
2     @MichaelJaegerTV	at_token
2     @Minusmensch	at_token
2     @Miri_the_Kiri	at_token
2     @MissRandom1986	at_token
2     @MissVanilly	at_token
2     @Missdilan	at_token
2     @Monnty2690	at_token
2     @Mortefarfalla	at_token
2     @MoviezKult	at_token
2     @MrWeg	at_token
2     @Muermel	at_token
2     @MurielKelleher	at_token
2     @NellyNiveaulog	at_token
2     @NessysWelt	at_token
2     @NewHowTV	at_token
2     @Nicoo4797	at_token
2     @NikSput	at_token
2     @NinaLovesAriana	at_token
2     @NoodLe3105	at_token
2     @OfficialArdianB	at_token
2     @OhOh_itsMagic	at_token
2     @OneDirectionAUT	at_token
2     @PaImtopTiger	at_token
2     @PatrickBernau	at_token
2     @Pendlomator	at_token
2     @PinkPlushWolfy	at_token
2     @PottAgent	at_token
2     @RADiO_HYSTERiA	at_token
2     @RRRockstah	at_token
2     @RazulAllah	at_token
2     @RedAngryBird	at_token
2     @Reinholdus	at_token
2     @Roockwood	at_token
2     @Roxaen	at_token
2     @SPIEGELONLINE	at_token
2     @Samaire	at_token
2     @SarahIsPlobnrg	at_token
2     @SarahK_96	at_token
2     @Sassu77	at_token
2     @SchokooMaedchen	at_token
2     @SeaShepherdDe	at_token
2     @ShannyVengeance	at_token
2     @SkySportNewsHD	at_token
2     @SmilerFiona	at_token
2     @SnowWittchen	at_token
2     @Snowcat2070	at_token
2     @Sollozzo01	at_token
2     @Sommermaedchen_	at_token
2     @StarlightCyrus	at_token
2     @Stef_aus_NRW	at_token
2     @Steffenster	at_token
2     @StereoSushisu	at_token
2     @SteveKanonfreak	at_token
2     @SteveRueck	at_token
2     @Stousn	at_token
2     @Suizidkatze87	at_token
2     @TheHeartBeatx	at_token
2     @TheHollyBennett	at_token
2     @TheOnlyKatha	at_token
2     @TiinaaLOL	at_token
2     @TimCattrall	at_token
2     @Timbanikki	at_token
2     @UARRR	at_token
2     @Unschuldsjunge	at_token
2     @UnsurpassableS	at_token
2     @VFC_FreakYoYo95	at_token
2     @Valerieous	at_token
2     @VellaAhalla	at_token
2     @Vicky_Freaky	at_token
2     @Voutshy	at_token
2     @Waldseepiratin	at_token
2     @Weseresk	at_token
2     @Whitypo	at_token
2     @Wishu_Kaiser	at_token
2     @Xanatori	at_token
2     @YahooDE	at_token
2     @Youarenotme2	at_token
2     @Zoor	at_token
2     @Zott_Monti	at_token
2     @Zuckermaedchen_	at_token
2     @_CaptainDan_	at_token
2     @_EnsarAnanas	at_token
2     @_Germanboy_	at_token
2     @_LadyGomez	at_token
2     @_Wolfsmaedchen	at_token
2     @_kleinMue	at_token
2     @_konna_	at_token
2     @_noujoum	at_token
2     @_phoeni	at_token
2     @_windrunner	at_token
2     @aceitocartao	at_token
2     @aecids	at_token
2     @aggro_	at_token
2     @alexdd55	at_token
2     @alleineohnedich	at_token
2     @ally_alert	at_token
2     @alostsong	at_token
2     @alx42	at_token
2     @andiheimann	at_token
2     @andizottmann	at_token
2     @annafeebaum	at_token
2     @antiprodukt	at_token
2     @anton290	at_token
2     @apfelcutter	at_token
2     @apple_Paaaapple	at_token
2     @atomazing	at_token
2     @babyfell	at_token
2     @babylovely_	at_token
2     @bartmeise	at_token
2     @beastlygray	at_token
2     @benni_b	at_token
2     @birtily	at_token
2     @blutenderEngel	at_token
2     @buergerstimme	at_token
2     @cajongroove	at_token
2     @caro_JM4ever	at_token
2     @chanmahardhika	at_token
2     @chieff89	at_token
2     @chresmos	at_token
2     @christiansoeder	at_token
2     @christopherkohn	at_token
2     @christopheruck	at_token
2     @codePrincess	at_token
2     @coldmirror	at_token
2     @copgirl2	at_token
2     @crazyJEADHEAD	at_token
2     @daelancrew	at_token
2     @dailyCbreak	at_token
2     @danielleicher	at_token
2     @danielmack	at_token
2     @danintown	at_token
2     @dave83x	at_token
2     @derSachse	at_token
2     @diamond_tears7	at_token
2     @dieseStella	at_token
2     @doktordab	at_token
2     @dorfgirl	at_token
2     @dpmdogma	at_token
2     @einefraueinwort	at_token
2     @eisy	at_token
2     @elenoreAM	at_token
2     @errinatamarad	at_token
2     @evelinhuter	at_token
2     @ffleon87	at_token
2     @flederzombie	at_token
2     @flexi_bell	at_token
2     @for_takeaway	at_token
2     @frasch25	at_token
2     @fuckyeahitsjuli	at_token
2     @gallenbitter	at_token
2     @gelsen	at_token
2     @gerryreinhardt	at_token
2     @ggvogt	at_token
2     @girlontravel	at_token
2     @gruene_at	at_token
2     @habichthorn	at_token
2     @haekelschwein	at_token
2     @haiku_shelf	at_token
2     @halbbluthobbit	at_token
2     @hausmeistah	at_token
2     @heise_de_tp	at_token
2     @helenS_mars	at_token
2     @helmi	at_token
2     @herrlarbig	at_token
2     @herzensdenkerin	at_token
2     @hildwin	at_token
2     @himbeermaedel	at_token
2     @hmull	at_token
2     @hoergen	at_token
2     @hofrat	at_token
2     @holadiho	at_token
2     @hutchinsane_	at_token
2     @huxi	at_token
2     @hvkson	at_token
2     @iHuzu	at_token
2     @iMarcintosh	at_token
2     @iPodTouchMichi	at_token
2     @iceprincess761	at_token
2     @ichwillansMeer	at_token
2     @infopointaudim	at_token
2     @inforrupt	at_token
2     @inkabrunini	at_token
2     @inschka	at_token
2     @jammiHH	at_token
2     @jensbernau	at_token
2     @jenshoffmann	at_token
2     @jensscholz	at_token
2     @joch_n	at_token
2     @johoheka4G	at_token
2     @julia_witt	at_token
2     @karin1210	at_token
2     @karrierebibel	at_token
2     @kc__dc	at_token
2     @kegelklub	at_token
2     @kesseltv	at_token
2     @kikamagazin	at_token
2     @kleinerrpunkt	at_token
2     @knuddellove	at_token
2     @knuffelbaerchen	at_token
2     @komal187	at_token
2     @koolsavas	at_token
2     @korbinian	at_token
2     @laRossa05	at_token
2     @laprintemps	at_token
2     @lelei	at_token
2     @lieselm	at_token
2     @linksfraktion	at_token
2     @lisa_germany	at_token
2     @luisas_view	at_token
2     @lutzii_TBG	at_token
2     @luziehtan_blog	at_token
2     @macerkopf_de	at_token
2     @madame_dine	at_token
2     @maharradit	at_token
2     @mala1978	at_token
2     @marcopolo71	at_token
2     @marcozehe	at_token
2     @marslight1185	at_token
2     @matthiasoomen	at_token
2     @mattiada	at_token
2     @maybe_innocent	at_token
2     @melimedhe	at_token
2     @meloveshopesolo	at_token
2     @menschentalent	at_token
2     @mh120480	at_token
2     @michl_mueller	at_token
2     @mingo713	at_token
2     @mischpoke84	at_token
2     @mix3bi	at_token
2     @moellus	at_token
2     @moni004	at_token
2     @moritzadler	at_token
2     @mrschtief	at_token
2     @mrsjaebeom_	at_token
2     @mueslikind	at_token
2     @my7voices	at_token
2     @nannilinchen	at_token
2     @nasenfaktor	at_token
2     @natalierulez_	at_token
2     @nerdprinzessli	at_token
2     @netnrd	at_token
2     @neverchuckless	at_token
2     @neverevertown	at_token
2     @nichtstefanraab	at_token
2     @nightingale78	at_token
2     @nkaulfuss	at_token
2     @nkotbgermany	at_token
2     @oberschaetzchen	at_token
2     @ozanstoppable	at_token
2     @pantoffelpunk	at_token
2     @pauli_pirat	at_token
2     @peed62	at_token
2     @peterbreuer	at_token
2     @petertauber	at_token
2     @phoenix_de	at_token
2     @photobix	at_token
2     @phroton	at_token
2     @piratenproll	at_token
2     @prasti_minja	at_token
2     @prinzessin_cat	at_token
2     @promotionbasis	at_token
2     @pseudoerbse	at_token
2     @queen0fpr0mise	at_token
2     @radiocottbus	at_token
2     @rebiger	at_token
2     @remaininlullaby	at_token
2     @ricardo_ch	at_token
2     @riotburnz	at_token
2     @rnl_handball	at_token
2     @roxor1911	at_token
2     @rrho	at_token
2     @sannipopanni	at_token
2     @saschu2011	at_token
2     @schokoeeis	at_token
2     @sekor	at_token
2     @simonelang	at_token
2     @simyo	at_token
2     @sleepy_housecat	at_token
2     @solflora	at_token
2     @spdbawue	at_token
2     @spox	at_token
2     @stn1978	at_token
2     @sunnypedia1987	at_token
2     @sunra1n_	at_token
2     @svente_fox	at_token
2     @swaglikemileyx	at_token
2     @sweetJordanK	at_token
2     @tanjanonymous	at_token
2     @thalertom	at_token
2     @theuer	at_token
2     @thomrosenhagen	at_token
2     @tilman36	at_token
2     @timpritlove	at_token
2     @tinchenxxxx	at_token
2     @titanic	at_token
2     @tobiasgillen	at_token
2     @tolga93	at_token
2     @trmtnzr	at_token
2     @trueffi	at_token
2     @ttms_de	at_token
2     @ufomedia	at_token
2     @validom	at_token
2     @vivaonline	at_token
2     @wandgrab	at_token
2     @wellpresso	at_token
2     @westsideblogger	at_token
2     @woiz	at_token
2     @worst_day_ever	at_token
2     @wsonja35	at_token
2     @wunderfitzig	at_token
2     @wurstkommission	at_token
2     @xAussenseiterin	at_token
2     @xFraanzii	at_token
2     @xSmileForBTRx	at_token
2     @xTherapie	at_token
2     @xUschiObermyla	at_token
2     @xheckyesbieber	at_token
2     @xtypischtieners	at_token
2     @yanyanmerong	at_token
2     @yewa	at_token
2     @zeitimbild	at_token
2     @zimtsternin	at_token
2     @zwyback	at_token
2     ABE	abbr
2     ATO40	abbr
2     AWESOME	fw
2     AX	abbr
2     Aaron	ne:person
2     Abs	abbr
2     Achern	ne:geo
2     Active	fw
2     Actors	fw
2     Admin	slang
2     Ads	neologism
2     Agility	fw
2     Ahh	inj
2     Ahhh	inj
2     Akoya	ne:product
2     Al	fw
2     Aloha	inj
2     Alois	ne:person
2     America	fw
2     Anastasia	ne:person
2     Andi	ne:person
2     Angelo	ne:person
2     Angels	fw
2     Animexx	ne:company
2     Anschlußstelle	compound
2     Anstoss	spell:Anstoß:substitution/deletion; dict
2     Arcanoa	ne:company
2     Arlberg	ne:geo
2     Aspire	ne:product
2     Aussenbordmotor compound
2     Ausserdem	spell:außerdem:substitution/insertion; dict
2     Autsch	inj
2     Ava	slang
2     Axo	spell:ach so:substitution/deletion; slang
2     Azubi	dict; slang
2     Azumi	ne:person
2     BB	abbr
2     BKH	abbr
2     BMV	ne:company
2     BROTHER	fw
2     BTR	abbr
2     BTW	 fw;  inj; slang
2     Banksterkanzlerin	compound
2     Baunatal	ne:geo
2     Bautzen	ne:geo
2     Bazooka	fw
2     Be	fw
2     Beauty	loan
2     Beckum	ne:geo
2     Bells	fw
2     Berchet	ne:company
2     Berlinale	ne:company
2     Bernau	ne:geo
2     Bienchen	dict;
2     Bitch	 slang; fw
2     BlackBerry	ne:product
2     Blade	ne:product
2     Blah	inj
2     Blue	fw
2     Bobadilla	ne:person
2     Bogy	ne:person
2     Bolle	ne:person
2     Bond	ne:person
2     BossHoss	ne:company
2     Bots	abbr; fw
2     Bundle	fw
2     Buzzer	neologism
2     Börner	ne:company
2     Büsser	ne:person
2     CARDEA	ne:product
2     CARE	ne:company
2     CC	slang
2     CE	ne:product
2     CHF	abbr
2     CLOSE	fw
2     CPI	abbr
2     CSS	abbr
2     CUBASE	ne:product
2     CX	ne:product
2     Cadeautjes	fw
2     Cafe	fw
2     Call	fw
2     Card	fw
2     Casa	fw
2     Casper	ne:person
2     Casting	neologism
2     Castings	neologism
2     CentrO	ne:geo
2     Central	ne:company
2     Championship	fw
2     Chelsea	ne:company
2     Chihuahuas	dict
2     Chillen	loan
2     Chocola	fw
2     Christkindlmarkt	compound
2     Christopher	ne:person
2     Chrome	ne:product
2     Cindy	ne:person
2     CityVille	ne:product
2     Clasico	ne:company
2     Classic	ne:product
2     Click	loan
2     Cloud	loan
2     Cocina	ne:product
2     Coda	ne:product
2     Coen	ne:person
2     Commerce	fw
2     Connox	ne:company
2     Contest	fw
2     Cosmo	ne:person
2     Court	ne:geo
2     Crystal	dict
2     Cyrus	ne:person
2     DHB	abbr; ne:company
2     DIe	dict
2     DOSB	abbr
2     Dabeisein	spell:dabei sein:substitution/deletion; dict
2     Dachdämmung	compound
2     Dahoam	slang
2     DailyDeal	fw
2     Dawn	fw
2     Days	fw
2     Dbox2	ne:product
2     Demosthenes	ne:person
2     Derby	dict
2     Despora	fw
2     Deu	spell:Deutsch:deletion
2     Diaries	fw
2     Dikka	 spell:Dicker:substitution; slang
2     Dinner	loan
2     Direction	fw
2     Directory	fw
2     Dott	ne:person
2     DropBox	ne:product
2     Dropbox	ne:product
2     DuMont	ne:company
2     Durban	ne:geo
2     EA	abbr; ne:company
2     EBK	abbr
2     EHF	abbr
2     EYES	fw
2     Easy	fw
2     Ebay	ne:company
2     Ebersbach	ne:geo
2     Ehr	spell:Ehre:deletion; dict
2     Elektrogeraet	 umlaut; compound
2     Elvis	ne:person
2     Emmy	ne:person
2     Emo	neologism
2     Eppendorf	ne:geo
2     Equinet	ne:company
2     Eric	ne:person
2     Erlanger	ne:geo
2     Erotikmesse	compound
2     Exo	fw
2     FCB	abbr
2     FEB	abbr
2     FOCUS	ne:product
2     FPÖ	ne:company
2     FU	abbr
2     FUCK	 fw; slang
2     Faißt	ne:person
2     Fake	loan
2     Fanclub	compound; loan
2     Fanpage	 compound; loan
2     Farid	ne:person
2     Feed	loan
2     Figl	ne:geo
2     Finance	fw
2     Flo	ne:person
2     Flux	ne:product
2     Fohr	ne:geo
2     Folgenswert	compound
2     Follow	fw
2     Force	fw
2     Forsc	spell:Forschung:deletion
2     Foursquare	ne:company
2     Fraport	ne:company
2     Fred	ne:person
2     Fuchsberger	ne:person
2     Full	fw
2     Fussball	spell:Fußball:substitution/insertion; dict
2     GERMAN	fw
2     GORGEOUS	fw
2     Gagas	ne:person
2     Gameplay	loan
2     Gaming	loan
2     Garavani	ne:person
2     Gary	ne:person
2     Gastebuch	umlaut
2     Gentner	ne:person
2     Gero	ne:person
2     Get	fw
2     Gibts	spell:gibt es:deletion; slang
2     Gin	ne:product
2     Gladbeck	ne:geo
2     Glitzer	dict
2     Glucksquell	umlaut
2     Glueck	umlaut
2     Go	fw
2     Goalunited	ne:product
2     Goerke24.	token
2     Gomez	ne:person
2     Goodbye	 fw; inj
2     Grand	fw
2     Grosse	spell:große:substitution/insertion; dict
2     Grossmütter	spell:Großmütter:substitution/insertion; dict
2     Group	fw
2     Gähn	inj
2     Götz	ne:person
2     HIERBOVEN	fw
2     HOCK	ne:company
2     HSV	abbr; ne:company
2     HTCInside	ne:company
2     Ha	inj
2     Haan	ne:geo
2     Haas	ne:person
2     Hamid	ne:person
2     Hamm	ne:geo
2     Hamsterrad	compound
2     Hangouts	neologism
2     Hansel	slang; ne:person
2     Hartz	neologism
2     Head	fw
2     Hebeanlage	compound
2     Heesters	ne:person
2     Hehe	inj
2     Hello	fw
2     Helloween	fw
2     Henava	ne:company
2     Herdprämie	compound
2     Herman	ne:person
2     Heroine	spell:Heroin:insertion; dict
2     Herten	ne:geo
2     Herzogenrath	ne:geo
2     Heut	spell:heute:deletion; slang
2     Heynckes	ne:person
2     Hilfeeee	elongation
2     Hm.	 token; inj
2     Hofer	ne:person
2     Holzspalter	compound
2     Home	fw
2     Hoppla	inj
2     Huch	inj
2     Hä	inj
2     IKEA	ne:company
2     IPad	ne:product
2     Ian	ne:person
2     Ibooks	ne:product
2     Iconia	ne:product
2     Ik	spell:ich:substitution/deletion; dict
2     Indie	fw
2     Infinity	ne:product
2     Interio	ne:product
2     Intro	slang
2     Irwie	 spell:irgendiwe:deletion; slang
2     Isch	spell:ich:insertion; dict
2     Jaaa	 elongation; inj
2     Jana	ne:person
2     Jannis	ne:person
2     Jap	inj
2     Jessi	ne:person
2     Jessie	ne:person
2     Jingle	loan
2     Joa	inj
2     Jobber	slang
2     Jobclick.	token
2     Joe	ne:person
2     Jogi	ne:person
2     Joko	ne:person
2     Jop	inj
2     Jos	abbr; ne:person
2     Jump	fw
2     KTM	abbr
2     Kabhi	fw
2     Kanns	spell:Kann es:deletion
2     Kannste	 spell:kannst du:deletion,substitution; slang
2     Kareen	ne:person
2     Karma	dict
2     Karsai	ne:person
2     Kerner	ne:person
2     Kerpen	ne:geo
2     King	fw; ne:product; ne:person
2     Kloten	ne:geo
2     Koble	spell:Koblenz:deletion
2     Kommafehler	compound
2     Komplottes	dict
2     Kristina	ne:person
2     Kroos	ne:person
2     KsvTRbhL	link
2     Ku	abbr
2     Kühlschr.	abbr
2     LR	ne:company
2     LTE	abbr
2     Lego	ne:product
2     Leigh	ne:person
2     Les	 spell:lese:deletion; slang
2     Leutle	slang
2     Li	ne:person; abbr
2     Lie	abbr; fw
2     Lifestyle	loan; compound
2     Lillehammer	ne:geo
2     Linkliste	compound
2     Lioness	fw
2     Lippert	ne:person
2     Literatwo	ne:company
2     Little	fw
2     Livecam	neologism
2     LoL	 slang; inj
2     Logic	ne:product
2     Loh	fw
2     Lookslikelink	ne:person
2     Loszeremonie	compound
2     Ludwigslust	ne:geo
2     Lusso	ne:product
2     Lyrics	fw
2     Län	spell:Länge:deletion
2     Lünen	ne:geo
2     MAGIX	ne:company
2     MAS	fw
2     MG	abbr
2     MT	at_token
2     MTN	abbr
2     MTV	abbr; ne:company
2     MURO	ne:company
2     MZ	abbr; ne:company
2     Madipedia	ne:company
2     Mahler	ne:person
2     Majo	abbr; dict
2     Mariah	ne:person
2     Maronen	dict
2     Marry	fw
2     Mass	fw
2     Maxi	ne:person
2     Maxxus	ne:product
2     Mbit	 neologism; abbr
2     Mc	abbr; fw
2     Mckinley	ne:person
2     MediaMarkt	ne:company
2     Mediadesign	ne:company
2     Mediation	fw
2     Medical	fw
2     Medion	ne:product
2     MeinPaket	ne:company
2     Melancholia	fw
2     Men	ne:company
2     Mercury	ne:person
2     Micro	abbr; fw
2     Mikro	dict
2     Mirko	ne:person
2     Mittweida	ne:geo
2     Mixtape	neologism
2     Montana	ne:person
2     MooTools	ne:product
2     Mose	ne:person
2     Motion	fw
2     Movie	fw
2     Mp3	abbr
2     Munchen	 ne:geo; umlaut
2     Music	loan
2     Must	fw
2     Märktel.	token
2     NDS	abbr
2     NEWAYS	ne:company
2     NHL	ne:company
2     NLP	abbr
2     NO	fw
2     Nabucco	ne:company
2     Nahles	ne:person
2     Nails	ne:company
2     Napster	ne:company
2     Nationalelf	compound
2     Navi	slang
2     Neckholder	ne:company
2     Nen	spell:einen:deletion; dict
2     Nena	ne:person
2     Net	spell:nicht:substitution/insertion; dict
2     Never	fw
2     Newman	ne:person
2     Newsticker	 loan
2     Ni	fw
2     Nicolas	ne:person
2     Nieblum	ne:geo
2     Niebüll	ne:geo
2     Niggemeier	ne:person
2     Nivea	ne:company
2     Noir	fw
2     Norman	ne:person
2     Nu	spell:nun:deletion; dict
2     Nuala	ne:person
2     Nudelfee	compound
2     OG	abbr
2     OO	inj; smiley
2     Ohja	inj
2     Organizer	loan
2     Osnabrücker	ne:geo
2     Oststeinbek	ne:geo
2     Outfit	loan
2     PE	ne:person
2     PUKY	ne:product
2     PVR	abbr
2     Pa	fw
2     Pasen	fw
2     Pauli	ne:company; ne:person
2     Peer	ne:person
2     Perlgarn	compound
2     Perro	ne:company
2     Petry	ne:person
2     Pff	inj
2     Pimp	fw
2     Ping	ne:product
2     Pinkelpause	compound
2     Pjanoo	fw
2     Pokemon	ne:person
2     Polish	fw
2     Polix	ne:product
2     Pollitz	ne:geo
2     Polo	dict
2     Polyester	dict
2     Poncho	loan
2     Ponyhof	compound
2     Popcorn	 loan; dict
2     Porn	 fw; slang
2     Potter	ne:person
2     Pr	spell:Preis:deletion
2     Praktiko	ne:product
2     Princess	ne:product
2     Probier	spell:probiere:deletion
2     Proclear	ne:product
2     Prof	abbr; dict
2     Prydz	ne:person
2     Prödl	ne:person
2     Pussy	 fw; slang
2     Putins	ne:person
2     QT	hash_tag
2     QooQoon	ne:company
2     Quetschkalotten	compound
2     Quizfrage	compound
2     Quizspiel	compound
2     Quotes	fw
2     RETWEET	slang
2     RIM	ne:company
2     RL	abbr
2     RNK	abbr
2     ROFL	abbr
2     RSC	abbr
2     RSS	neologism
2     Ra	fw
2     Rack	ne:product
2     Radolfzell	ne:geo
2     Raffhose	compound
2     Ramen	fw
2     Rammschutz	compound
2     Ranking	loan
2     Ratenkredit	compound
2     Rayman	 ne:person; ne:product
2     Raymond	ne:person
2     Rea	ne:person
2     Reader	loan
2     Rees	ne:geo
2     Reflecta	ne:product
2     Reichensteuer	compound
2     Relaunch	loan
2     Remake	loan
2     Replay	loan
2     Reunion	loan
2     Revelations	fw
2     Rhodan	ne:person
2     Rhon	ne:geo
2     Rica	ne:geo
2     Rida	ne:person
2     Rihanna	ne:person
2     Robertson	ne:person
2     Rofl	abbr
2     Ron	ne:person
2     Rosso	fw; ne:person
2     Rotz	dict; slang
2     Rousseff	ne:person
2     Row	ne:product
2     Ruhrpott	ne:geo
2     Ryan	ne:person
2     Räikkönen	ne:person
2     Rösler	ne:person
2     Rübenberge	ne:geo
2     SALE	loan
2     SEH	fw
2     SL	abbr
2     SM	abbr
2     SN	abbr
2     SSD	 abbr; neologism
2     ST2	ne:product
2     SUV	 abbr; neologism
2     SX	ne:product
2     Saarlouis	ne:geo
2     Sachsenring	ne:geo
2     Sale	loan
2     Sami	ne:person
2     Sarkozy	ne:person
2     Sarvar	ne:geo
2     Sat1	ne:company
2     Scandlines	ne:company
2     Scenery	loan
2     Schatzchen	umlaut
2     Scheffler	ne:person
2     Schiri	slang
2     Schoki	slang
2     School	fw
2     Schortens	ne:geo
2     Schutzengelbilder	compound
2     Schwalbach	ne:geo
2     Scott	ne:person
2     Script	loan
2     Scrubs	 fw; ne:product
2     Scénic	ne:product
2     Sea	ne:geo
2     Second	fw
2     Series	fw
2     Setlur	ne:person
2     Sevelen	ne:company
2     Sexcam	 loan
2     Seyfarth	ne:company
2     Shine	fw
2     Shiply	ne:company
2     Shirts	loan
2     Shoppen	loan
2     Simpson	ne:person
2     Sinterklaas	fw
2     Skyrim	ne:product
2     Smartphones	neologism
2     Smeet	ne:product
2     Smile	ne:product
2     Solingen	ne:geo
2     Somerhalder	ne:person
2     Sorgerecht	compound
2     Soso	inj
2     Sourcrowd	fw
2     SpOn	abbr
2     Specials	loan
2     Spencer	ne:person
2     Spielemagazin	compound
2     Std	abbr
2     Stendal	ne:geo
2     Sticks	loan
2     Stocker	ne:person
2     Stokke	ne:product
2     Stop	dict; inj
2     Straks	 spell:stracks:deletion; slang
2     Subliminals	fw
2     Suesser	umlaut
2     Summinet	ne:company
2     Sunshine	fw
2     Supi	 spell:super:substitution; slang
2     Swingerparty	compound
2     Sync	slang
2     TB	abbr
2     TBG	abbr
2     TERRARIUM	dict
2     TG	abbr
2     TIME	fw
2     TUV	umlaut
2     Tac	token
2     Tak	fw
2     Tangled	ne:product
2     TechniSat	ne:company
2     Teds	ne:person
2     Teen	loan
2     Th	spell:Thema:deletion
2     Thai	dict
2     Thank	 inj; fw
2     This	fw
2     Tic	inj
2     Tihi	inj
2     Tips	dict
2     Together	fw
2     Tokyo	ne:geo
2     Tollwood	ne:geo
2     Torsten	ne:person
2     Tr	spell:Trade:deletion
2     Track	loan
2     Tradigist	ne:geo
2     Trainee	fw
2     Traume	umlaut
2     Treasures”	token
2     Tripp	ne:product
2     Tschagajew	ne:person
2     Twitpic	ne:company
2     UK	abbr
2     Uber	umlaut
2     Uckermann	ne:person
2     Uh	inj
2     Ulbig	ne:person
2     Uli	ne:person
2     Usher	ne:person
2     VIGNON	ne:product
2     Val	ne:person
2     Valentino	ne:person
2     Vera	ne:person
2     Verjaardag	fw
2     Very	fw
2     Vettel	ne:person
2     VfL	abbr
2     Vielzitzenmäuse	compound
2     Viersen	ne:geo
2     ViralUrl	ne:company
2     Vitelle	ne:product
2     Votze	slang
2     WD	abbr
2     WH	abbr
2     WOW	inj
2     WZ	abbr
2     Wa	fw
2     Wah	inj
2     Walk	loan
2     Wau	inj
2     Wave	fw
2     Weicon	ne:product
2     Welcome	 inj; fw
2     Wels	dict
2     Wenns	spell:wenn es:deletion
2     Why	fw
2     WiFi	 abbr; neologism
2     WikiLeaks	ne:company
2     Wilpert	ne:person
2     Windabweiser	dict
2     Wintec	ne:product
2     WippWalker	ne:product
2     Wisconsin	ne:geo
2     Wissenschafter	spell:Wissenschaftler:deletion
2     Wohn	token
2     Women’s	fw
2     WordPress	ne:product
2     World	fw
2     WpHG	abbr
2     Wuhu	inj
2     Wulff	ne:person
2     Wärmetauscher	compound
2     Wünsch	spell:wünsche:deletion; slang
2     XDDDDDD	smiley
2     XXL	abbr
2     Xmas	 slang; fw
2     Xylitol	dict
2     YB	abbr
2     YOUR	fw
2     Yep	inj
2     You	fw
2     Young	fw
2     Youporn	ne:company
2     Zelda	ne:person
2     Zillertal	ne:geo
2     Zubehoer	umlaut
2     Zuviel	spell:zu viel:deletion
2     aba	spell:aber:substitution/deletion; slang
2     abgesprengt	dict
2     abierta	ne:company
2     absicht	dict
2     achja	inj
2     adventskalender	compound
2     aha	inj
2     ahaha	inj
2     ahahahah	inj
2     ahhhh	 elongation; inj
2     al	fw
2     alay	fw
2     alls	spell:alles:deletion
2     amanha	fw
2     andrea	ne:person
2     anfang	dict
2     ank	fw
2     annoying	fw
2     anschluss	dict
2     anyone	fw
2     are	fw
2     arena	dict
2     argh	inj
2     artar	fw
2     artikel	dict
2     as	fw
2     asia	fw
2     atuh	fw
2     ausser	dict
2     ausserdem	spell:außerdem:substitution; dict
2     aynen	fw
2     baby	dict
2     backbord	dict
2     bad	dict; fw
2     bastel	spell:bastele:deletion; slang
2     bauch	dict
2     bayreuth	ne:geo
2     bday	 fw;  spell:birthday:deletion; slang
2     be	fw
2     beat	loan
2     beber	fw
2     befreuntet	spell:befreundet:deletion
2     beine	dict
2     beli	fw
2     berug	fw
2     beschä	spell:beschämen:deletion
2     best	fw
2     better	fw
2     bettwäsche	compound
2     bieber	ne:person
2     biin	elongation
2     bij	fw
2     bilder	dict
2     bins	 spell:bin es:deletion; slang
2     bir	fw
2     biste	 spell:bist du:; slang
2     bit.	token
2     boa	inj
2     br	fw
2     bravo	inj
2     bro	 spell:brother:deletion; slang
2     broo	fw
2     bu	fw
2     buchstaben	dict
2     button	loan
2     ca	 abbr; dict
2     cam	 abbr; loan
2     cari	fw
2     ccm	abbr
2     cd	neologism
2     checken	loan
2     chillen	loan
2     cih	spell:ich:substitution
2     club	loan
2     cok	fw
2     comSysto	ne:company
2     coolsten	loan
2     cyberport	loan
2     daa	elongation
2     daaa	elongation
2     daar	fw
2     dah	fw
2     dallas	ne:geo
2     darfste	 spell:darfst du:deletion; slang
2     dd	abbr
2     deal	loan
2     debatte	dict
2     deh	fw
2     deluxe	ne:product
2     dennen	spell:denen:insertion
2     depri	 spell:deprimiert:deletion; slang
2     dey	fw
2     dh	fw
2     dialekt	dict
2     diamantiert	dict
2     dirk	ne:person
2     dissen	slang
2     diye	fw
2     doeix	fw
2     dolle	spell:doll:insertion; slang
2     donaukurier.	token
2     download	loan
2     draussen	spell:draußen:substitution; dict
2     drum	spell:darum:deletion; slang
2     duisburg	ne:geo
2     dun	fw
2     duu	elongation
2     düsseldorf	ne:geo
2     düştükçe	fw
2     ebay	ne:company
2     een	spell:einen:deletion; slang; fw
2     eier	dict
2     eigentl.	abbr
2     electronic	fw
2     eltern	dict
2     email	neologism
2     entfolgt	neologism
2     erdkunde	dict
2     erinner	spell:erinnere:deletion; slang
2     esch	spell:echt:insertion/deletion; slang
2     ess	 spell:esse:deletion; slang
2     etw	spell:etwas:deletion
2     eu	abbr
2     euro	 neologism; dict
2     ey.	inj
2     fail	loan
2     fands	 spell:fand es:deletion; slang
2     fang	spell:fange:insertion; slang
2     farbe	dict
2     fernsehprogramm	compound
2     feuerwehr	dict
2     fi	fw
2     fickmaul	slang
2     first	fw
2     fiyat	fw
2     followerpower	 loan
2     form	dict
2     forum	dict
2     fotos	dict
2     frauen	dict
2     freitickets	 compound; loan
2     freude	dict
2     friedhöfe.	token
2     funny	loan
2     fußball	dict
2     fü	spell:für:deletion
2     gaa	fw
2     ganti	fw
2     gay	neologism
2     gedanken	dict
2     geheimnis	dict
2     gelegenheit	dict
2     geniesst	spell:genießt:substitution
2     gepruft	umlaut
2     gerad	 spell:gerade:deletion; slang
2     geretweetet	neologism
2     geschenke	dict
2     geschichte	dict
2     geschichtsträchtige	compound
2     geschri	spell:geschrieben:deletion
2     gewundert	dict
2     gg.	abbr
2     gibi	fw
2     gigaspeed	ne:product
2     git	spell:gibt:deletion; slang; ne:product
2     gk	fw
2     gladbach	ne:geo
2     gnaaa	inj
2     goede	slang
2     gold	dict
2     gone	fw
2     got	fw
2     gottschalk	ne:person
2     grosser	spell:großer:substitution
2     grosses	spell:großes:substitution
2     gruß	dict
2     gud	 spell:good:substitution; fw
2     hahahahaha	inj
2     hannah	ne:person
2     hass	dict
2     haun	 spell:hauen:deletion; slang
2     hauptsache	compound
2     have	fw
2     hdl	abbr
2     head	fw
2     heey	inj
2     heilbronn	ne:geo
2     heise	ne:company
2     heisst	spell:heißt:substitution
2     hihihi	inj
2     hochgeladen.	token
2     hochzeit	dict
2     hoff	spell:hoffe:deletion
2     homepage	loan
2     homophoben	dict
2     hot	loan
2     hotel	dict
2     hours	fw
2     html5	neologism
2     huft	inj
2     hund	dict
2     hungry	fw
2     hut	fw
2     hälfte	dict
2     hätts	 spell:hätte es:deletion; slang
2     höhöhö	inj
2     iTunes	ne:product
2     iedereen	fw
2     iktisat	fw
2     inner	spell:innere:deletion
2     iphone	ne:product
2     isser	 spell:ist er:substitution,deletion; slang
2     isso	fw
2     itunes	ne:product
2     iwelche	 spell:irgendwelche:deletion; slang
2     jagger	ne:person
2     jahren	dict
2     jap	inj
2     jared	ne:person
2     jed	spell:jeder:deletion
2     jedermanns	dict
2     jedesmal	spell:jedes Mal:deletion; slang
2     jmd	abbr
2     jmd.	abbr
2     jtz	spell:jetzt:deletion
2     jup	inj
2     jus	fw; slang
2     kackt	dict
2     kalender	dict
2     kali	fw
2     kamel	dict
2     kamer	fw
2     kannste	 spell:kannst du:deletion,substitution; slang
2     kaya	ne:person
2     ke	spell:keinen:deletion
2     kek	fw
2     kenapa	fw
2     kijke	fw
2     kino.	token
2     kinox	ne:company
2     kiw	fw
2     kkk	abbr; fw
2     kkkkkkkk	fw
2     klassiker	dict
2     klavier	dict
2     ko	fw
2     kom	spell:komme:deletion
2     kommentar	dict
2     konzert	dict
2     kopfkratz	smiley
2     kos	fw
2     koşan	fw
2     krankenhaus	dict
2     kucken	 spell:gucken:substitution; slang
2     kuduro	loan
2     kwi	fw
2     kya	fw
2     köln	ne:geo
2     laeuft	umlaut
2     lak	inj
2     lala	slang
2     land	dict
2     langeweile	dict
2     laptop	neologism
2     laune	dict
2     lebens	dict
2     lebih	fw
2     lenksäulensteuergerät	compound
2     lenny	ne:person
2     lern	spell:lerne:deletion; slang
2     letzt	spell:letzten:deletion
2     leuten	dict
2     leverkusen	ne:geo
2     lisawolf	ne:person
2     loco	fw
2     loh	fw
2     looken	loan
2     low	fw
2     lsw	abbr
2     ludwigshafen	ne:geo
2     ly	link
2     läßt	spell:lässt:substitution/insertion
2     lünkern	slang
2     machts	 spell:macht es:deletion; slang
2     mak	fw
2     maken	loan
2     manno	inj
2     mas	fw
2     mate	ne:product
2     mathe	slang
2     mati	fw
2     maus	dict
2     mcih	spell:mich:substitution
2     mega	dict
2     meh	inj
2     meister	dict
2     merci	 fw; inj
2     mim	fw
2     mind	abbr
2     minuten	dict
2     mist	dict; slang
2     mitn	 spell:mit einem:deletion; slang
2     ml	abbr
2     mlm	fw
2     monate	dict
2     monaten	dict
2     montana	ne:person
2     more	fw
2     mousesports	ne:company
2     muka	fw
2     mund	dict
2     mußte	spell:musste:substitution
2     naaa	 elongation; inj
2     nachhause	spell:nach Hause:deletion
2     nachlegen	dict
2     nachmittag	dict
2     nachricht	dict
2     naechsten	umlaut
2     nanti	fw
2     nase	dict
2     naturgeile	dict
2     nazis	 dict; slang
2     neee	 elongation; slang
2     neeein	elongation
2     nenn	spell:nenne:deletion; slang
2     neuigkeiten	dict
2     ng	fw
2     niall	ne:person
2     nichtmehr	spell:nicht mehr:deletion
2     niggas	slang
2     nih	fw
2     nit	spell:nicht:deletion
2     nk	fw
2     non	fw
2     not	fw; dict
2     nou	fw
2     now	fw
2     nummer	dict
2     nung	fw
2     oda	spell:oder:substitution/deletion; slang
2     ohje	inj
2     ok.	 inj; token
2     oke	 inj; slang
2     oki	 inj; slang
2     opo	fw
2     ordnung	dict
2     ots	abbr
2     ouml	fw
2     outfit	loan
2     pa	fw
2     pacha	ne:geo
2     pack	spell:packe:deletion; slang
2     parah	fw
2     park	dict
2     paßt	spell:passt:substitution/deletion
2     pech	dict
2     pengen	fw
2     pietro	ne:person
2     pingen	neologism
2     pinkelst	 dict; slang
2     pisan	fw
2     playing	fw
2     pon	fw
2     port	loan; dict
2     postet	neologism
2     posting	loan
2     pra	fw
2     proler	slang
2     prust	smiley
2     puncak	fw
2     pöbeln	dict
2     random	fw
2     rathaus	dict
2     rbb	abbr
2     renn	spell:renne:deletion; slang
2     reply	fw
2     rest	dict
2     rockt	loan
2     rs	abbr
2     rt	slang
2     rtl	ne:company
2     sache	dict
2     sachen	dict
2     sama	fw
2     sami	ne:person
2     says	fw
2     sc	spell:schwerer:deletion
2     schaft	spell:schafft:deletion
2     schenk	spell:schenke:deletion; slang
2     schenkenhttp	spell:schenken http:deletion
2     schleime	dict
2     schließ	spell:schließe:deletion; slang
2     schmeiß	spell:schmeiße:deletion; slang
2     schoen	umlaut
2     schonwieder	spell:schon wieder:deletion
2     school	fw
2     schweiz	dict
2     schweizer	dict
2     schwester	dict
2     seeeehr	elongation
2     seen	fw
2     sehn	spell:sehen:deletion; slang
2     semoga	fw
2     setz	spell:setze:deletion; slang
2     sevinme	fw
2     siapa	fw
2     sidn	spell:sind:substitution
2     siehste	 spell:siehst du:deletion,substitution; slang
2     sies	spell:sie es:deletion; slang; fw
2     sih	fw
2     sim	fw
2     sinn	dict
2     sky	ne:company
2     skype	ne:product
2     slecht	 spell:schlecht:deletion; slang
2     sms	neologism
2     sol	spell:solche:deletion
2     song	dict; loan
2     spast	slang
2     spasti	slang
2     spontandemonstration	compound
2     sport	dict
2     spox.	token
2     stalker	neologism
2     staub	dict
2     std	abbr
2     stehn	 spell:stehen:deletion; slang
2     sten	token
2     story	loan; dict
2     strip	loan; dict
2     studier	spell:studiere:deletion; slang
2     stylische	dict
2     sueddeutsche.	link
2     suit	inj
2     szlig	fw
2     sänger	dict
2     sätze	dict
2     süss	spell:süß:substitution/insertion
2     talep	fw
2     tante	dict
2     tapi	fw
2     tasche	dict
2     tee	dict
2     temen	fw
2     termin	dict
2     text	dict
2     than	fw
2     therme	dict; loan
2     thumbs	fw
2     thx.	 token; inj
2     till	fw
2     tk	link
2     tl	abbr
2     tlg	fw
2     toi	inj
2     trag	spell:trage:deletion; slang
2     tweetet	neologism
2     twiät.	link
2     typen	dict
2     tätschel	smiley
2     tür	dict
2     türchen	dict
2     ua	abbr
2     uber	umlaut
2     uch	inj
2     uhhh	inj
2     uhr.	token
2     uhuk	inj
2     ujung	fw
2     ukuran	fw
2     umarm	 spell:umarme:deletion; slang
2     umarmung	dict
2     ur	fw
2     uuh	inj
2     vaillant	ne:company
2     valla	inj
2     vergess	 spell:vergesse:deletion; slang
2     verpeilt	slang
2     verspätung	dict
2     versuchs	spell:versuche es:deletion; slang
2     vid	abbr
2     video.	token
2     vids	 spell:videos:deletion; slang
2     vietnam	ne:geo
2     vll	abbr
2     vllt.	token
2     vorweihnachtszeit	compound
2     vou	fw
2     vs	abbr
2     wahnsinn	dict
2     wasser	dict
2     weetje	fw
2     wegn	spell:wegen:deletion
2     weihnachtsmarkt	compound
2     weilchen	dict
2     well	fw
2     werbung	dict
2     whoa	inj
2     wi	spell:wir:deletion
2     wiede	spell:wieder:deletion
2     wirtschaft	dict
2     wissenschaftl	spell:wissenschaftliche:deletion
2     wlan	abbr; fw; loan
2     woah	inj
2     woche.	token
2     wohn	spell:wohne:deletion; slang
2     wolke	dict
2     worte	dict
2     ww	link
2     wärest.	token
2     xD.	smiley
2     xP	smiley
2     xperia	ne:product
2     xxxx	smiley
2     yamaha	ne:product
2     your	fw
2     zB	abbr
2     zdf	abbr; ne:company
2     zeiten	dict
2     zock	slang
2     zoll	dict
2     zuende	umlaut
2     zuguckn	 spell:zugucken:deletion; slang
2     zw.	abbr
2     ª	fw
2     Ø	fw
2     ß	fw
2     änder	spell:ändern:deletion
2     çok	fw
2     é	fw
2     öko	abbr; dict
2     üb	fw
2     überleg	spell:überlege:deletion; slang
2     “Amy	token
2     „WE	token
2     한편으로는	fw
