Aaah	Ah
aach	ach
aangekomen	angekommen
aba	aber
abmache	abmachen
Abo	Abonnement
abstürtze	abstürzte
achso	ach so
Achso	Ach so
ae	eine
aeltesten	ältesten
af	auf
ahahahahha	aha
ahhhh	ah
ahhhhhhhhhhhhhhhhhhhhhhhh	ah
aku	Akku
alls	alles
Alot	A lot
alsooo	also
änder	ändern
ang	angekündigt
angeko	angekommen
Ansch	Anschaffung
artzt	Arzt
aso	also
Atomkraftwer	Atomkraftwerk
aufjedenfall	auf jeden Fall
aufm	auf dem
aufrechenen	aufrechnen
Auschlussverfahren	Ausschlussverfahren
auuuuuch	auch
Axo	ach so
Backlinkpfli	Backlinkpflicht
bastel	bastele
bday	birthday
Be	Berlin
be	betrinken
bedin	bedingungsloses
beeinträchtig	beeinträchtigen
befesti	befestigen
befreuntet	befreundet
bekomm	bekomme
bekommenn	bekommen
beschä	beschämen
besonder	besonders
besoofen	besoffen
bezweilfe	bezweifle
biin	bin
BildernBei	Bildern Bei
bins	bin es
bisexuel	bisexuell
biste	bist du
blie	blieb
bro	brother
bytch	bitch
Cappucino	Cappuccino
chillin	cilling
Chönnt	Könnte
cih	ich
Cubra	Cuba
daaa	da
daa	da
dacht	dachte
dah	da
Dän	Dänemark
Dänemurks	Dänemarks
Danisch	Dänisch
dankee	danke
darfste	darfst du
dat	das
Dat	das
dennen	denen
depri	deprimiert
deshalp	deshalb
desswegen	deswegen
Deu	Deutsch
Deuts	Deutschland
Dikka	Dicker
dm	dem
dolle	doll
doll	toll
drann	dran
drüber	darüber
draus	daraus
dr	der
dr	dir
dr	dran
drum	darum
duerfen	dürfen
dun	dann
durecke	drücke
duu	du
duuuuuuuuuuurch	durch
Editio	Edition
een	einen
Ehr	Ehre
Eigentlichheit	Eigentlichkeit
eigntlich	eigentlich
EINFA	EINFACH
Einkaufsa	Einkaufsabteilung
Eisnachemangere	Eins nach dem anderen
Elektrogeraet	Elektrogerät
erhiel	erhielt
erinner	erinnere
erlich	ehrlich
erringenMit	erringen Mit
ertränk	ertränke
ertsmal	erstmal
erzäh	erzählen
esch	echt
ess	esse
etw	etwas
fahrn	fahren
fands	fand es
fang	fange
fi	finde
Finanzministe	Finanzminister
find	finde
Find	Finde
fine	finde
Fir	Firmen
fol	folgende
Forsc	Forschung
Franzoesisch	Französisch
Free2Play	free to play
freu	freue
Freu	freue
fuer	für
Fuer	Für
fü	für
fühl	fühle
fur	für
FUUUUUUUUUUUUUUUUUUUUUUUUUUUUUUUUUU	FUU
gaaaanz	ganz
Ga	geh
gangigen	gängigen
garnicht	gar nicht
Gastebuch	Gästebuch
GeburtstagViel	Geburtstag viel
Gedaechtnis	Gedächtnis
geei	geeignet
ge	gestern
gehn	gehen
gehts	geht es
gehtsmit	geht es mit
gemeins	gemein
gepruft	geprüft
gerad	gerade
geschlafn	geschlafen
geschri	geschrieben
geschuetzte	geschützte
gesehn	gesehen
gibts	gibt es
Gibts	gibt es
git	gibt
Glucksquell	Glücksquell
Glueck	Glück
goettingen	Göttingen
grade	gerade
grad	gerade
EU-Grossma	EU-Grossmacht
grossrtig	grossartig
Gruenden	Gründen
Grundstueck	Grundstück
Gründungsphas	Gründungsphase
gud	good
guteee	gute
Haamburg	Hamburg
habn	haben
habs	habe es
ham	haben
hät	hätte
hats	hat es
hätt	hätte
hätts	hätte es
haun	hauen
heint	heute
heist	heisst
Heroine	Heroin
herumgsprungen	herumgesprungen
Heutemittag	heute Mittag
heut	heute
Heut	heute
Hilfeeee	Hilfe
hingehn	hingehen
hoch4	hoch 4
Hoerbuch	Hörbuch
hoff	hoffe
Hoffnu	Hoffnung
Hoooot	Hot
Huette	Hütte
Ichdichauch	Ich dich auch
ichs	ich es
ic	ich
Ick	Ich
ihrs	ihres
ik	ich
Ik	ich
immernoch	immer noch
inner	innere
irgendne	irgendeine
Irwie	irgendiwe
isch	ich
Isch	Ich
isser	ist er
isses	ist es
iwelche	irgendwelche
iwie	irgendwie
jaaaaa	ja
jaaaa	ja
jaaa	ja
Jaaa	Ja
jaa	ja
Jaa	Ja
Jah	Jahren
Jakpot	Jackpot
jedesmal	jedes Mal
jed	jeder
JesusEure	Jesus Eure
jetz	jetzt
jez	jetzt
jtz	jetzt
Juhuuu	Juhu
jz	jetzt
Ka	Kategorien
Kame	Kamera
kamer	kammer
Kanns	Kann das
kanns	kann es
kanns	Kann es
Kanns	Kann es
Kanns	Kannst
kannste	kannst du
Kannste	kannst du
ke	keinen
kenn	kenne
Ker	Kerstin
kgAugenfrabe	Augenfarbe
killn	killen
Kinderstuh	Kinderstuhl
Kindervon	Kinder von
kingt	klingt
kisss	kiss
Klaar	Klar
klassi	klassischer
knnen	können
Koble	Koblenz
koftschmersen	Kopfschmerzen
kom	komme
komt	kommt
Kons	Konsequenzen
Kopp	Kopf
Kriegsse	kriegst du
kucken	gucken
kuck	guck
Kurtze	Kurze
lad	lade
laeuft	läuft
Landu	Landung
langweilichrrrrrrrrr	langweilig
Län	Länge
le	legen
le	leiden
lern	lerne
les	lese
Les	lese
letze	letzte
letzt	letzten
lieeeebe	liebe
liegts	liegt es
Looksreen	Lockscreen
looool	lol
m8	macht
maaann	mann
maanchmal	manchmal
machts	macht es
ma	mal
Ma	Mama
ManagerSOS	Manager SOS
Mas	Masse
mcht	macht
mcih	mich
MEDI	MEDIAN
meinste	meinst du
mer	mir
met	mit
midm	mit dem
mitn	mit einem
mocht	gemacht
moechte	möchte
moenchengladbach	mönchengladbach
mom	moment
MorgenpostCSU	Morgenpost CSU
muesst	müsst
Multimedi	Multimedia
Munchen	München
n8	Nacht
naaa	na
nachdeinem	nach deinem
nachhause	nach Hause
Nachrichte	Nachrichten
Nachti	Nacht
Nac	Nachrichten
naechsten	nächsten
namlich	nämlich
nciht	nicht
nd	nicht
ned	nicht
neeein	nein
neee	nee
ne	eine
Ne	eine
neet	nicht
nehm	nehme
nem	einem
nen	einen
Nen	einen
nenn	nenne
ner	einer
nerv	nerve
net	nicht
Net	nicht
Netzansc	Netzanschluss
nich	nicht
nichtmehr	nicht mehr
nichtsmehr	nichts mehr
Nierlande	Niederlande
ni	nicht
ni	nie
ni	niemand
nit	nicht
nix	nichts
Nix	nichts
noerdlich	nördlich
nog	noch
No	Na
no	noch
nuhr	nur
Nunja	nun ja
nu	nun
Nu	nun
nurnoch	nur noch
oda	oder
odeer	oder
oooh	oh
Orginalen	Originalen
pack	packe
Pa	Partei
pauscha	pauschal
piratebayäääähm	piratebay ähm
pls	please
pppppffffhhhh	pfh
Probier	probiere
Proble	Probleme
Pr	Preis
PunktenEs	Punkten Es
PunktenIch	Punkten Ich
Put	Putin
raffs	raffe es
rauf	herauf
rauskommen	herauskommen
renn	renne
RF31Erleben	RF31 Erleben
rüber	herüber
rum	herum
sauf	saufe
Schaaaaaaaaaaaaatz	Schatz
schaft	schafft
Schatzchen	Schätzchen
schaun	schauen
scheiseee	scheisse
scheiss	Scheisse
Scheiss	Scheisse
schenkenhttp	schenken http
schenk	schenke
schlaf	schlafe
schliess	schliesse
schmeiss	schmeisse
schn	schnellstens
schoenes	schönes
schoen	schön
schonmal	schon mal
schonwieder	schon wieder
schöööner	schöner
scho	schon
schuleund	schule und
Schwдnze	Schwänze
sc	schwerer
SC	schwerer
seeeehr	sehr
seen	sehen
sehn	sehen
seh	sehe
SEH	SEHE
SEH	THE
selb	selbst
seriö	seriöse
Sersn	Servus
se	sie
setz	setze
shauhauhauahsuhau	Shauhaus
sic	sicher
sidn	sind
siegtenBadische	siegten badische
siehste	siehst du
sielen	spielen
sies	sie es
Silbertren	Silbertrennung
singl	Singleleben
sitz	sitze
slafen	schlafen
slecht	schlecht
sol	solche
Sonderkondi	Sonderkondition
son	so ein
soooo	so
sooo	so
Sooo	So
soo	so
sost	sonst
spaeter	später
spass	Spass
spast	spasst
spingst	spinnst
Spontant	spontan
sprech	spreche
sry	sorry
Sry	Sorry
stecks	steck es
stehn	stehen
stehts	steht es
Stinkts	Stinkt es
Straks	stracks
studier	studiere
Suesser	Süsser
Supi	super
süüss	süss
Tabellenführ	Tabellenführer
Tach	Tag
Tätigkeits	Tätigkeit
teeny18j.	Teeny 18 J.
tendier	tendiere
Thermopap	Thermopapier
Th	Thema
trag	trage
Transsexuellensch	Transsexuellenschönheit
Traume	Träume
träum	träume
Tr	Trade
TUV	TÜV
überleg	überlege
uber	über
Uber	Über
Übrigen™	Übrigens
UFrom	From
umarm	umarme
un	und
unverschluesselt	unverschlüsselt
verbeiten	verbreiten
verfolgungtour	Verfolgungstour
vergess	vergesse
verpest	verpesten
Versan	Versand
versuchs	versuche es
ve	verstehe
vids	videos
Vid	Video
vi	viel
vllt	vielleicht
vomFreund	vom Freund
voodka	Vodka
vorallem	vor allem
Vorallem	Vor allem
Vorraussichtliche	voraussichtliche
Vorwüfe	Vorwürfe
vo	vor
Waaaaah	Wah
Waaaaas	Was
waere	wäre
wärs	wäre es
wars	war es
wär	wäre
wa	wir
wcwette	WC Wette
wegn	wegen
weils	weil es
weisste	weisst du
weis	weiss
wenns	wenn es
Wenns	Wenn es
werds	werde es
werd	werde
Werd	Werde
weten	wetten
We	Weltliteratur
We	Werder
Whg	Wohnung
wiede	wieder
willkommn	willkommen
Wintertr	Wintertrainers
wirds	wird es
Wissenschafter	Wissenschaftler
wissenschaftl	wissenschaftliche
wi	wir
Wohlfuehlcharakter	Wohlfühlcharakter
wohn	wohne
wrhaben	wir haben
Wtal	Wuppertal
Wundesschöner	Wunderschöner
wünsch	wünsche
Wünsch	wünsche
würd	würde
xTheSulution	xTheSolution
Yaaaaa	Ya
zeiche	zeige
zenit	Zeit
Zubehoer	Zubehör
zuende	zu Ende
zuguckn	zugucken
zuhause	zu Hause
zunächtst	zunächst
zurücklehen	zurücklegen
zuuu	zu
zuviele	zu viele
zuviel	zu viel
Zuviel	zu viel
zyn	sind
Schoenheit	Schönheit
FRUSINAIch	FRUSINA Ich
wellt	Welt
OnlineÜber	Online Über
AktienBerliner	Aktien Berliner
MorgenpostDer	Morgenpost Der
TräumeLiebeToleranzFrieden	Träume Liebe Toleranz Frieden
obe	Oberweite
fürDamen	für Damen
Parteiflüge	Parteiflügel
Nachtfotografier	Nachtfotografien
MondeoBei	Mondeo Bei
Immobilien geschäft	Immobiliengeschäft
Gammel Tag	Gammeltag
Derierung	Regierung
muenchen	München
befind	befindet
rumgetrolle	Herumgetrolle
6,50Poulardenbrust	6,50 Poulardenbrust
Vereini	Vereinigten
moin	Morgen
Käpt'n	Kapitän
wen iig	wenig
le	leichten
