181   lt	link
143   bpt	abbr
112   gt	link
96    RT	slang
96    wettendass	
67    is	fw
62    ff	abbr
58    grad	 slang; spell:gerade:deletion
57    Gottschalk	ne:person
41    Stardoll	ne:company
40    offenbings	
39    gepostet	loan
39    haha	inj
36    Tweets	loan
35    BGE	abbr
33    Na	inj
33    nix	
32    Guttenberg	ne:person
30    sowas	dict
29    ok	inj
26    naja	
26    wär	 slang; spell:wäre:deletion
25    Haha	inj
25    The	fw
25    erstmal	dict
25    gibts	 slang; spell:gibt es:deletion
25    heut	 slang; spell:heute:deletion
24    OMGermanTeen	
24    Offenbings	
24    gehts	 slang; spell:geht es:deletion
24    na	inj
24    net	
23    freu	 slang; spell:freue:deletion
22    fb	 abbr; ne:company
21    find	 slang; spell:finde:deletion
21    nem	 slang; spell:einem:deletion
20    Jauch	ne:person
19    Germany	fw
19    Tweet	
19    iPhone	ne:product
19    nacht	dict
19    piraten	 ne:company; dict
19    werd	 slang; spell:werde:deletion
18    Naja	
18    WettenDass	
18    grade	 slang; spell:gerade:deletion
18    on	fw
17    BPT	abbr
17    sorry	 inj; fw
17    twitter	ne:company
16    EUR	abbr
16    Social	loan
16    Sorry	 inj; fw
16    ey	inj
16    kenn	 slang; spell:kenne:deletion
16    rum	 slang; spell:herum:deletion
16    video	dict
16    würd	 slang; spell:würde:deletion
15    App	loan
15    German	fw
15    Ok	inj
15    Re	slang
15    abend	dict
15    htt	link
15    ner	 slang; spell:einer:deletion
14    Ah	inj
14    DJ	loan
14    Schweiger	ne:person
14    di	fw
14    tvprogramm	
14    tweets	loan
13    bild	dict
13    for	fw
13    geld	dict
13    tag	dict
13    twittern	neologism
12    Black	fw
12    DTN	abbr
12    FB	 abbr; ne:company
12    Galaxy	ne:product
12    Hey	inj
12    Jungs	slang
12    MP	abbr
12    Nö	slang
12    SMS	neologism
12    TL	abbr
12    ah	inj
12    fur	spell:für:substitution
12    leute	dict
12    min	abbr
12    to	fw
11    Game	fw
11    Nowitzki	ne:person
11    OMG	abbr
11    Pageballs	ne:company
11    Stream	loan
11    berlin	ne:geo
11    co	link
11    cont	fw
11    film	dict
11    handy	dict
11    hehe	inj
11    ma	
11    my	fw
10    Domian	
10    Ey	inj
10    Gladbach	ne:geo
10    HANSGROHE	ne:company
10    Happy	fw
10    Voice	fw
10    WE	
10    cc	slang
10    fail	loan
10    geb	abbr
10    hPa	abbr
10    habs	 slang; spell:habe es:deletion
10    hahaha	inj
10    hey	inj
10    hm	inj
10    iOS	ne:product
10    iPad	ne:product
10    jaa	 inj; elongation
10    mmt	
10    nowplaying	
10    posten	loan
10    seo	 fw; abbr
10    soo	elongation
10    stapo	
10    xx	smiley
9     BVB	 ne:company; abbr
9     Blu	ne:product
9     Is	fw
9     Quoka	
9     Reus	ne:person
9     Timeline	loan
9     boah	inj
9     facebook	ne:company
9     garnicht	spell:gar nicht:deletion
9     glück	dict
9     hach	inj
9     lust	dict
9     ned	 slang; spell:nicht:substitution,deletion
9     news	
9     no	fw
9     nö	slang
9     scho	spell:schon:deletion
9     up	fw
9     wars	 slang; spell:war es:deletion
9     wetter	dict
9     wow	inj
9     youtube	ne:company
8     Day	fw
8     HS	abbr
8     Hbf	abbr
8     Justin	ne:person
8     Like	fw
8     Night	fw
8     One	fw
8     Sat	ne:company
8     Shirt	loan
8     Til	ne:person
8     Weihnachts	token
8     aw	abbr
8     by	fw
8     domian	
8     followerpower	loan
8     gÃ	
8     hammer	dict
8     ht	link
8     inkl	dict
8     it	fw
8     jahre	dict
8     la	fw
8     leid	dict
8     like	fw
8     mann	dict
8     nee	slang
8     nstigsten	
8     omg	abbr
8     ppm	abbr
8     son	spell:so ein:deletion
8     spass	
8     tweet	
8     typ	dict
8     we	
8     welt	dict
8     zdf	 ne:company; abbr
7     Android	ne:product
7     Bonds	dict
7     Browsergame	compound
7     Chihuahua	dict
7     Christmas	fw
7     Gottschalks	ne:person
7     Hm	inj
7     Let	fw
7     Limmat	ne:geo
7     Maffay	ne:person
7     Min	abbr
7     Nee	slang
7     ON	fw
7     Och	inj
7     PA	fw
7     Receiver	loan
7     Red	fw
7     Sky	ne:company
7     Sowas	dict
7     St	abbr
7     Titten	slang
7     Twitterer	neologism
7     Weltcup	loan
7     Zwickauer	ne:geo
7     alverde	
7     auto	dict
7     aww	inj
7     bekomm	spell:bekomme:deletion
7     bett	dict
7     bge	abbr
7     deal	loan
7     dpa	abbr
7     dr	spell:dran:deletion
7     etc	abbr
7     euro	 dict; neologism
7     ha	inj
7     immernoch	spell:immer noch:deletion
7     isch	
7     iwie	spell:irgendwie:deletion
7     jetz	spell:jetzt:deletion
7     köln	ne:geo
7     namen	dict
7     of	fw
7     quot	fw
7     ray	ne:person
7     schaun	 slang; spell:schauen:deletion
7     schonmal	spell:schon mal:deletion
7     show	loan
7     spiel	dict
7     sry	
7     twittert	neologism
7     vllt	spell:vielleicht:deletion
7     wa	
7     winter	dict
7     woche	dict
7     wochenende	compound
7     wünsch	 slang; spell:wünsche:deletion
7     you	fw
7     Äh	inj
6     Bah	inj
6     Biel	ne:geo
6     Breaking	fw
6     Browserspiel	compound
6     CROCS	ne:product
6     Cayman	ne:product
6     FCB	abbr
6     Find	 slang; spell:finde:deletion
6     Follower	loan
6     GER	
6     GO	fw
6     GermanTeens	
6     Hot	loan
6     House	fw
6     Jaa	 inj; elongation
6     Jorge	ne:person
6     Life	fw
6     Livestream	loan
6     Liveticker	loan
6     Löw	ne:person
6     Marco	ne:person
6     Mario	ne:person
6     Meat	fw
6     No	fw
6     Now	fw
6     Oo	
6     Playmobil	ne:product
6     Tommy	ne:person
6     UnderTheMistletö	
6     WTF	 slang; inj
6     Wow	inj
6     Xbox	ne:product
6     Yeah	inj
6     aufm	dict
6     augen	dict
6     dapd	ne:company
6     down	fw
6     eig.	abbr
6     em	
6     fan	loan
6     fcb	abbr
6     fuck	 slang; fw
6     fühl	spell:fühle:deletion
6     gesehn	 slang; spell:gesehen:deletion
6     go	fw
6     gott	dict
6     hmm	inj
6     hunger	dict
6     hätt	 slang; spell:hätte:deletion
6     jahr	dict
6     jobs	
6     meins	 slang; dict
6     mum	slang
6     problem	dict
6     retweetet	neologism
6     rtl	ne:company
6     schatz	dict
6     sendung	dict
6     stunden	dict
6     the	fw
6     tja	inj
6     top	loan
6     tv	abbr
6     uhr	dict
6     vo	spell:vor:deletion
6     weihnachten	dict
6     wenns	
6     wirds	 slang; spell:wird es:deletion
6     Ã	
5     Acer	ne:company
5     Achso	 inj; spell:ach so:deletion
5     Air	fw
5     Amy	ne:person
5     Audio	dict
5     Avatar	ne:person
5     Aw	abbr
5     Axor	ne:product
5     Bieber	ne:person
5     Big	fw
5     Bio	abbr
5     Britney	ne:person
5     Bushido	fw
5     Cain	ne:person
5     Carrier	fw
5     Cyber	fw
5     Do	abbr
5     Fashion	fw
5     FragdieGurus	
5     Freu	 slang; spell:freue:deletion
5     Gingerbread	ne:product
5     GuruAdventskalender	
5     HH	abbr
5     Hach	inj
5     IPT	
5     Ick	 slang; spell:Ich:substitution
5     Juhu	inj
5     Loaf	ne:person
5     Map	fw
5     Minecraft	ne:product
5     NegSmileyen	
5     Newsfunk	
5     OO	
5     Of	fw
5     On	fw
5     Path	fw
5     Phoenix	ne:company
5     Play	fw
5     Playing	fw
5     Podolski	ne:person
5     Skyrim	ne:product
5     Slim	fw
5     Special	fw
5     Temp	abbr
5     Time	fw
5     WAVE	fw
5     Werd	 slang; spell:werde:deletion
5     achso	 inj; spell:ach so:deletion
5     and	fw
5     arbeit	dict
5     bier	dict
5     blah	inj
5     blog	neologism
5     bundesliga	
5     check	loan
5     deutschland	ne:geo
5     effzeh	
5     ehm	inj
5     faven	 neologism; slang
5     fen	
5     finds	fw
5     freundin	dict
5     gebloggt	neologism
5     getwittert	neologism
5     gg	 inj; smiley
5     gottschalk	ne:person
5     gov	
5     hats	 slang; spell:hat es:deletion
5     hertha	
5     heuteshow	
5     iTunes	ne:product
5     internet	neologism
5     ju	inj
5     ka	
5     krieg	dict
5     les	 slang; spell:lese:deletion
5     life	fw
5     mh	inj
5     musik	dict
5     münchen	
5     nehm	 slang; spell:nehme:deletion
5     nerv	 slang; spell:nerve:deletion
5     off	fw
5     papa	dict
5     prÃ	
5     quoka	
5     retweeten	neologism
5     satz	dict
5     schlaf	 dict; spell:schlafe:deletion
5     seh	
5     sem	
5     sitz	 slang; spell:sitze:deletion
5     smo	
5     spd	
5     stunde	dict
5     suchmaschinenoptimierung	
5     thema	dict
5     un	spell:und:deletion
5     vie	
5     wochen	dict
5     wärs	 slang; spell:wäre es:deletion
5     zuviel	
4     Aha	inj
4     Alina	ne:person
4     Ardian	ne:person
4     BR	fw
4     Bag	fw
4     Berben	ne:person
4     Blitzer	slang
4     Boah	inj
4     Borussen	ne:person
4     Bujupi	ne:person
4     Bullshit	 slang; loan
4     Bye	 inj; fw
4     CS	 fw;  ne:product; abbr
4     Camera	ne:product
4     Cap	ne:product
4     Community	loan
4     Cup	loan
4     DS	 ne:product; abbr
4     DSDS	abbr
4     Dance	loan
4     Danisch	spell:Dänisch:substitution
4     Dez	abbr
4     Elstner	ne:person
4     FQ	
4     Fantasy	fw
4     Faymann	ne:person
4     Free	fw
4     Friends	fw
4     Girls	fw
4     Güss	
4     HTC	 ne:company; abbr
4     Headset	loan
4     High	loan
4     Hmm	inj
4     ID	abbr
4     IPTFFFFFF	
4     Ice	fw
4     Ih	inj
4     Kate	ne:person
4     Kindle	ne:product
4     LOVE	loan
4     Lan	abbr
4     Lattek	ne:person
4     Lopes	ne:person
4     Love	loan
4     Luftfeuchte	compound
4     Make	fw
4     Mathe	slang
4     Mike	ne:person
4     Model	loan
4     My	fw
4     NBA	ne:company
4     OF	fw
4     Ohh	inj
4     Open	fw
4     Pechstein	ne:person
4     Podcast	loan
4     Promi	slang
4     Purple	fw
4     Read	fw
4     Rewe	ne:company
4     Ribéry	
4     Ryanair	ne:company
4     SSNHD	
4     SWR	
4     Salzungen	ne:geo
4     Schoko	token
4     Schuhbeck	ne:person
4     Shit	 inj;  slang; fw
4     Smartphone	neologism
4     SocialMedia	
4     South	fw
4     Spongebob	ne:person
4     Steinbrück	ne:person
4     Store	fw
4     Style	fw
4     Tablet	neologism
4     Tablets	neologism
4     Tach	 slang; spell:Tag:substitution
4     Taiji	ne:geo
4     ThyssenKrupp	ne:company
4     Ticker	loan
4     Till	fw
4     Tja	inj
4     To	fw
4     Touch	ne:product
4     Tweetdiebstahl	compound
4     Tweetkalender	
4     Ui	inj
4     Up	fw
4     Vegas	ne:geo
4     Wah	inj
4     Winehouse	ne:person
4     With	fw
4     add	
4     adventskalender	compound
4     ahnung	dict
4     akku	abbr
4     amp	fw
4     app	loan
4     ard	ne:company
4     at	fw
4     awesome	fw
4     bayern	ne:geo
4     bescheid	dict
4     bruder	dict
4     buch	dict
4     buli	
4     christmas	fw
4     design	loan
4     entfolgen	neologism
4     evmakir	
4     fall	dict
4     fehler	dict
4     feier	dict
4     forum	dict
4     foto	dict
4     friedrichshafen	ne:geo
4     good	fw
4     google	ne:company
4     gräber	dict
4     hahah	inj
4     hamburg	
4     haus	dict
4     he	inj
4     hilfe	dict
4     iPod	ne:product
4     ic	spell:ich:deletion
4     idee	dict
4     jaja	inj
4     joa	inj
4     justin	ne:person
4     jz	 slang; spell:jetzt:deletion
4     kmh	abbr
4     leipzig	
4     lied	dict
4     liked	fw
4     max	ne:person
4     me	fw
4     mensch	dict
4     menschen	dict
4     mitte	dict
4     montag	dict
4     name	dict
4     nu	
4     out	fw
4     party	loan
4     pc	neologism
4     phoenix	ne:company
4     pic	 slang; fw
4     response	fw
4     riesenehre	compound
4     rofl	abbr
4     sc	spell:schwerer:deletion
4     se	 slang; spell:sie:deletion
4     seite	dict
4     sex	dict
4     shoppen	loan
4     thanks	
4     tommys	ne:person
4     trends	
4     twikolaus	
4     twitterst	neologism
4     ui	inj
4     unwiderstehl	
4     uuml	fw
4     ver	link
4     very	fw
4     videos	dict
4     voice	fw
4     vorallem	
4     wdr	
4     weils	 slang; spell:weil es:deletion
4     wien	ne:geo
4     yeah	inj
4     zb	abbr
4     zocken	dict
4     zuviele	 dict; spell:zu viele:deletion
4     ähm	inj
3     -D	
3     ABBA	ne:company
3     Achja	
3     Admin	slang
3     Ali	ne:person
3     Assassin	ne:product
3     Atomic	fw
3     Axo	 slang; spell:ach so:substitution/deletion
3     BE	fw
3     Bandana	dict
3     Barth	ne:person
3     Battlefield	
3     Beat	loan
3     Beckum	ne:geo
3     BenQ	ne:product
3     Best	fw
3     Birthday	fw
3     Books	fw
3     Bravo	
3     Buys	fw
3     CELAC	abbr
3     CSS	abbr
3     Canvas	loan
3     Carrerabahn	compound
3     Case	loan
3     Castor	
3     Channel	loan
3     Chili	dict
3     Chris	ne:person
3     Christkindlmarkt	compound
3     Chuck	ne:person
3     Comedy	
3     Coral	ne:geo
3     Creed	ne:product
3     DF	
3     DGAP	abbr
3     Dan	ne:person
3     Dark	fw
3     Date	loan
3     Dax	ne:company
3     December	fw
3     Despres	ne:person
3     Di	fw
3     Duma	fw
3     EA	 ne:company; abbr
3     EIL	abbr
3     Easy	fw
3     El	fw
3     Email	neologism
3     End	fw
3     Entertainment	fw
3     Escort	loan
3     European	ne:company
3     FFM	abbr
3     FML	abbr
3     FPÖ	ne:company
3     Fahrplanwechsel	compound
3     Feng	fw
3     Fewo	
3     Flavonmax	ne:company
3     Flo	ne:person
3     Fuck	 slang; fw
3     GT	link
3     Games	fw
3     Girl	fw
3     Good	fw
3     Goodbye	 inj; fw
3     Green	fw
3     Hahahaha	inj
3     Hanke	ne:person
3     Hannah	ne:person
3     Hartz	neologism
3     Hashtag	neologism
3     Heels	loan
3     Hellboy	ne:person
3     Hetero	dict
3     HiFi	 fw; abbr
3     Hidden	fw
3     Hihi	inj
3     Hobbies	dict
3     Hoffenheim	ne:geo
3     Hunziker	ne:person
3     Husky	dict
3     IKEA	ne:company
3     IMG	 fw; abbr
3     Jared	ne:person
3     Jessica	ne:person
3     Jupp	ne:person
3     Jülich	
3     Ka	
3     Karsai	ne:person
3     Keep	fw
3     Keramag	ne:product
3     Key	fw
3     Keys	fw
3     Kids	loan
3     Kindervon	spell:Kinder von:deletion
3     Klaas	ne:person
3     Kombo	slang
3     Krupp	ne:company
3     LG	slang
3     LV	abbr
3     La	fw
3     Labbadia	ne:person
3     Label	loan
3     League	fw
3     Lichterkette	compound
3     Lopez	ne:person
3     Lu	 ne:geo; ne:person
3     MEGATEST	
3     MW	
3     Ma	
3     MacBook	ne:product
3     Maps	fw
3     Maroon	ne:company
3     Mascara	ne:product
3     Mate	ne:product
3     Medion	ne:product
3     Michelle	ne:person
3     Mp	abbr
3     Muhammad	ne:person
3     Multiplayer	loan
3     NLP	abbr
3     NW	abbr
3     Nachti	 slang; spell:Nacht:insertion
3     Nexus	ne:product
3     Nike	ne:product
3     Nix	
3     Norris	ne:person
3     OK	inj
3     Oha	inj
3     PM	abbr
3     Palace	fw
3     Paradise	fw
3     Payne	ne:person
3     Plait	ne:product
3     Please	 fw; inj
3     Pocket	fw
3     PosSmileyas	
3     Pr	spell:Preis:deletion
3     Prelaunch	loan
3     Primera	 ne:product; ne:company
3     Proble	spell:Probleme:deletion
3     Promo	 neologism; slang
3     PunktenIch	spell:Punkten Ich:deletion
3     Puzzlepaneelen	compound
3     RP	abbr
3     Resistance	 ne:product; fw
3     Rex	 ne:product; ne:person
3     Rinderschocker	compound
3     Ruhl	ne:geo
3     SC	spell:schwerer:deletion
3     SEO	 fw; abbr
3     SF	abbr
3     SG	abbr
3     SSL	abbr
3     SVP	abbr
3     SW	abbr
3     SWTOR	
3     Saar	ne:geo
3     Sander	ne:person
3     Sans	fw
3     Sarah	ne:person
3     Sarkozy	ne:person
3     Schmitz	ne:person
3     Security	loan
3     Seller	loan
3     Share	loan
3     Shopping	loan
3     Shui	fw
3     Siri	ne:product
3     Smartphones	neologism
3     Sms	neologism
3     Soundtrack	loan
3     Sry	
3     Starck	ne:product
3     Stick	loan
3     THE	fw
3     THQ	abbr
3     TK	
3     TO	fw
3     Tab	abbr
3     Tenny	slang
3     TheDome	
3     Toma	ne:person
3     Traffic	loan
3     Treasures	
3     Tweetklau	compound
3     Twist	loan
3     Vera	ne:person
3     Vinyl	dict
3     Virtual	fw
3     Vorallem	
3     Vorrundengegner	compound
3     WD	abbr
3     White	fw
3     Witt	ne:person
3     Xavier	ne:person
3     Xing	
3     YEAH	inj
3     Yay	inj
3     Yes	 fw; inj
3     ZDFinfo	
3     Zelda	ne:person
3     account	loan
3     adden	loan
3     ahh	inj
3     aka	slang
3     aku	 slang; abbr
3     album	dict
3     alkohol	dict
3     arena	dict
3     arsch	dict
3     art	dict
3     aso	spell:also:deletion
3     ausgang	dict
3     bad	 fw; dict
3     bb	abbr
3     bella	ne:person
3     bissl	slang
3     bock	dict
3     bus	dict
3     bvb	 ne:company; abbr
3     bye	 inj; fw
3     bzw	dict
3     ch	link
3     chemie	dict
3     chrom	dict
3     cop	
3     couch	dict
3     crocs	ne:product
3     dacht	spell:dachte:deletion
3     dad	 slang; loan
3     dat	 slang; spell:das:substitution
3     ding	dict
3     downloaden	neologism
3     draus	 dict; spell:daraus:deletion
3     düsseldorf	ne:geo
3     ebay	ne:company
3     ebook	neologism
3     ei	dict
3     eig	abbr
3     eis	dict
3     entfolgst	neologism
3     erinnerungen	dict
3     erlich	spell:ehrlich:deletion
3     familie	dict
3     feat	fw
3     flasche	dict
3     follower	loan
3     frau	dict
3     free	fw
3     freunde	dict
3     fussball	 dict; spell:Fußball:substitution/insertion
3     gaga	ne:person
3     gehn	spell:gehen:deletion
3     gitarre	dict
3     gruppe	dict
3     haare	dict
3     habn	 slang; spell:haben:deletion
3     ham	 slang; spell:haben:substitution/deletion
3     happy	fw
3     haushaltsauflösung	
3     hinbekomme	dict
3     hochgeladen	dict
3     home	
3     hotel	dict
3     hust	inj
3     hät	spell:hätte:deletion
3     hö	inj
3     ihrs	 dict; spell:ihres:deletion
3     iphone	ne:product
3     japp	inj
3     jep	inj
3     jepp	inj
3     jez	spell:jetzt:deletion
3     jo	inj
3     jobsuche	
3     jojo	 ne:product; ne:person
3     kacken	 dict; slang
3     kaffee	dict
3     kanns	spell:Kann es:deletion
3     karte	dict
3     katze	dict
3     knp	
3     komt	spell:kommt:deletion
3     le	fw
3     leine	dict
3     lern	 slang; spell:lerne:deletion
3     leverkusen	ne:geo
3     lmao	slang
3     markt	
3     markt.	token
3     mathe	slang
3     media	
3     mer	 slang; spell:mir:substitution
3     mittwoch	dict
3     mom	 slang; spell:moment:deletion
3     moment	dict
3     movie	fw
3     much	fw
3     mutter	dict
3     männer	dict
3     nciht	spell:nicht:substitution
3     ne	
3     ni	
3     nice	fw
3     nurnoch	spell:nur noch:deletion
3     nä	inj
3     oO	
3     och	inj
3     oha	inj
3     oje	inj
3     olle	slang
3     org	link
3     philosophy	
3     pink	dict
3     present	fw
3     profil	dict
3     radio	
3     rauf	 slang; spell:herauf:deletion
3     rauskommen	 dict;  slang; spell:herauskommen:deletion
3     right	fw
3     rüber	 dict;  slang; spell:herüber:deletion
3     sau	dict
3     schatje	fw
3     schluss	dict
3     schwanz	dict
3     sic	spell:sicher:deletion
3     sis	slang
3     sky	ne:company
3     sorry.	token
3     ss	
3     stadt	dict
3     standard	dict
3     stehts	 slang; spell:steht es:deletion
3     stellenangebote	
3     stück	dict
3     sz	abbr
3     szonline	
3     tabletten	dict
3     tages	dict
3     taz	
3     teamfollowback	
3     ten	
3     test	dict
3     timeline	loan
3     tod	dict
3     träum	 dict; spell:träume:deletion
3     ts	inj
3     twittere	neologism
3     twoff	
3     tztztz	inj
3     unverbraucht	dict
3     upd	fw
3     usw	dict
3     ve	fw
3     vi	spell:viel:deletion
3     voten	loan
3     vs	abbr
3     week	fw
3     weis	 dict; spell:weiß:deletion
3     wel	fw
3     what	fw
3     wlan	 fw;  loan; abbr
3     wohnung	dict
3     work	fw
3     wort	dict
3     yay	inj
3     äh	inj
3     österreich	ne:geo
2     ABE	abbr
2     AH	inj
2     ATO	
2     AWESOME	fw
2     AX	abbr
2     AZ	
2     Aaron	ne:person
2     Abs	abbr
2     Achern	ne:geo
2     Active	fw
2     Actors	fw
2     Ads	neologism
2     Adventsk	
2     Agility	fw
2     Ahh	inj
2     Aichacher	
2     Akoya	ne:product
2     Al	fw
2     Alemannia	
2     Alois	ne:person
2     America	fw
2     Anastasia	ne:person
2     Andi	ne:person
2     Angelo	ne:person
2     Angels	fw
2     Animexx	ne:company
2     Arcanoa	ne:company
2     Arlberg	ne:geo
2     Aspire	ne:product
2     Austria	
2     Autsch	inj
2     Ava	slang
2     Azubi	 slang; dict
2     Azumi	ne:person
2     BF	
2     BKH	abbr
2     BMV	ne:company
2     BROTHER	fw
2     BSC	
2     BTR	abbr
2     BTW	 inj;  slang; fw
2     Banksterkanzlerin	compound
2     Baunatal	ne:geo
2     Bautzen	ne:geo
2     Bazooka	fw
2     Beauty	loan
2     BeaverCreek	
2     Bells	fw
2     Berchet	ne:company
2     Berlinale	ne:company
2     Bernau	ne:geo
2     Bienchen	; dict
2     Birkenbihl	
2     Bitch	 fw; slang
2     BlackBerry	ne:product
2     Blacky	
2     Blade	ne:product
2     Blah	inj
2     Blue	fw
2     Bo	ne:person
2     Bobadilla	ne:person
2     Bogy	ne:person
2     Bolle	ne:person
2     Bond	ne:person
2     BossHoss	ne:company
2     Bots	 fw; abbr
2     BuLi	
2     Bundle	fw
2     Businessplan	
2     Buzzer	neologism
2     Bvb	 ne:company; abbr
2     Börner	ne:company
2     CARDEA	ne:product
2     CARE	ne:company
2     CC	slang
2     CE	ne:product
2     CHF	abbr
2     CLOSE	fw
2     CPI	abbr
2     CUBASE	ne:product
2     CX	ne:product
2     Cafe	fw
2     Call	fw
2     Card	fw
2     Cars	
2     Casa	fw
2     Casper	ne:person
2     Casting	neologism
2     Castings	neologism
2     CentrO	ne:geo
2     Central	ne:company
2     Championship	fw
2     Chelsea	ne:company
2     Chihuahuas	dict
2     Chillen	loan
2     Christopher	ne:person
2     Chrome	ne:product
2     Cindy	ne:person
2     CityVille	ne:product
2     Clasico	ne:company
2     Classic	ne:product
2     Click	loan
2     Cloud	loan
2     Cocina	ne:product
2     Coda	ne:product
2     ComedyCentral	
2     Commerce	fw
2     Connox	ne:company
2     Contest	fw
2     Cosmo	ne:person
2     Court	ne:geo
2     Crystal	dict
2     CuReSoft	
2     Cyberport	loan
2     Cyrus	ne:person
2     Cön	
2     DD	abbr
2     DDD	smiley
2     DEPR	
2     DHB	 ne:company; abbr
2     DIe	dict
2     DOMEA	
2     DONG	 inj; fw
2     DOSB	abbr
2     Dabeisein	 dict; spell:dabei sein:substitution/deletion
2     Dachdämmung	compound
2     Dahoam	slang
2     DailyDeal	fw
2     Dawn	fw
2     Days	fw
2     Dbox	
2     Demosthenes	ne:person
2     Derby	dict
2     Despora	fw
2     Deu	spell:Deutsch:deletion
2     Diaries	fw
2     Dikka	 slang; spell:Dicker:substitution
2     Dinner	loan
2     Direction	fw
2     Directory	fw
2     DonGermanTVtoday	
2     Doodle	
2     Dott	ne:person
2     DropBox	ne:product
2     Dropbox	ne:product
2     DuMont	ne:company
2     Durban	ne:geo
2     EBK	abbr
2     EC	
2     EHF	abbr
2     EYES	fw
2     Ebay	ne:company
2     Ebersbach	ne:geo
2     Ehr	 dict; spell:Ehre:deletion
2     EinsExtra	
2     EinsPlus	
2     Elvis	ne:person
2     Emmy	ne:person
2     Emo	neologism
2     Eppendorf	ne:geo
2     Equinet	ne:company
2     Eric	ne:person
2     Erlanger	ne:geo
2     Erotikmesse	compound
2     Exo	fw
2     Ezio	
2     FAIL	loan
2     FCBayern	
2     FCK	
2     FEB	abbr
2     FFFUUU	
2     FM	
2     FOCUS	ne:product
2     FS	
2     FU	abbr
2     FUCK	 slang; fw
2     Faisst	
2     Fake	loan
2     Fanpage	 loan; compound
2     Faolain	
2     Farid	ne:person
2     Feed	loan
2     Figl	ne:geo
2     Finance	fw
2     FloraPower	
2     Flux	ne:product
2     Fohr	ne:geo
2     Folgenswert	compound
2     Follow	fw
2     FollowFriday	
2     Followerpower	loan
2     Force	fw
2     Forex	
2     Forsc	spell:Forschung:deletion
2     Foursquare	ne:company
2     Fraport	ne:company
2     Fred	ne:person
2     Friday	fw
2     Fuchsberger	ne:person
2     Full	fw
2     GORGEOUS	fw
2     Gagas	ne:person
2     Gameplay	loan
2     Garavani	ne:person
2     Gary	ne:person
2     Gastebuch	umlaut
2     Gentner	ne:person
2     Gero	ne:person
2     Get	fw
2     Gibts	 slang; spell:gibt es:deletion
2     Gladbeck	ne:geo
2     Glitzer	dict
2     Glucksquell	umlaut
2     Go	fw
2     Goalunited	ne:product
2     Gr.	abbr
2     Grand	fw
2     Group	fw
2     Guben	
2     Gähn	inj
2     Göppingen	
2     Götz	ne:person
2     HIMYM	
2     HSV	 ne:company; abbr
2     HTCInside	ne:company
2     Ha	inj
2     Haan	ne:geo
2     Haas	ne:person
2     Hack	
2     Hahaha	inj
2     Hamid	ne:person
2     Hamm	ne:geo
2     Hamsterrad	compound
2     Hangouts	neologism
2     Hansel	 ne:person; slang
2     Head	fw
2     Heart	
2     Hebeanlage	compound
2     Heesters	ne:person
2     Hehe	inj
2     Henava	ne:company
2     Herdprämie	compound
2     Herman	ne:person
2     Heroine	 dict; spell:Heroin:insertion
2     Herten	ne:geo
2     Herzogenrath	ne:geo
2     Heut	 slang; spell:heute:deletion
2     Heynckes	ne:person
2     Hm.	 inj; token
2     Hofer	ne:person
2     Holzspalter	compound
2     Home	
2     Hoppla	inj
2     Huch	inj
2     Hunziger	
2     Hä	inj
2     Höhner	
2     IPad	ne:product
2     Ian	ne:person
2     Ibooks	ne:product
2     Iconia	ne:product
2     Ik	
2     Indesit	
2     Indie	fw
2     Infinity	ne:product
2     Interio	ne:product
2     Intro	slang
2     Irish	
2     Irwie	 slang; spell:irgendiwe:deletion
2     Isch	
2     Jamie	
2     Jana	ne:person
2     Jannis	ne:person
2     Jap	inj
2     Jessi	ne:person
2     Jessie	ne:person
2     Jingle	loan
2     Joa	inj
2     Jobber	slang
2     Joe	ne:person
2     Jogi	ne:person
2     Joko	ne:person
2     Jop	inj
2     Jos	 ne:person; abbr
2     Jump	fw
2     KSC	
2     KTM	abbr
2     Kanns	spell:Kann es:deletion
2     Kareen	ne:person
2     Karma	dict
2     Kerner	ne:person
2     Kerpen	ne:geo
2     King	 ne:person;  ne:product; fw
2     Kloten	ne:geo
2     Koble	spell:Koblenz:deletion
2     Kommafehler	compound
2     Komplottes	dict
2     Kristina	ne:person
2     Kroos	ne:person
2     KsvTRbhL	link
2     Ku	abbr
2     Kühlschr.	abbr
2     LR	ne:company
2     LTE	abbr
2     LastActionSEO	
2     Lego	ne:product
2     Leigh	ne:person
2     Les	 slang; spell:lese:deletion
2     Leutle	slang
2     Li	 abbr; ne:person
2     Lich	
2     Lie	 fw; abbr
2     Lifestyle	 compound; loan
2     Lillehammer	ne:geo
2     Linkliste	compound
2     Lioness	fw
2     Lippert	ne:person
2     Literatwo	ne:company
2     Little	fw
2     Livecam	neologism
2     Loh	fw
2     Lookslikelink	ne:person
2     Loszeremonie	compound
2     Ludwigslust	ne:geo
2     Lusso	ne:product
2     Lyrics	fw
2     Län	spell:Länge:deletion
2     Lünen	ne:geo
2     MAGIX	ne:company
2     MAS	fw
2     MEGADOTS	
2     MG	abbr
2     MTN	abbr
2     MTV	 ne:company; abbr
2     MURO	ne:company
2     MZ	 ne:company; abbr
2     Madipedia	ne:company
2     Majo	 dict; abbr
2     Mariah	ne:person
2     Maronen	dict
2     Marry	fw
2     Mas	fw
2     Maxi	ne:person
2     Maxxus	ne:product
2     Mbit	 abbr; neologism
2     Mc	 fw; abbr
2     Mckinley	ne:person
2     Me	fw
2     MediaMarkt	ne:company
2     Mediadesign	ne:company
2     Mediation	fw
2     Medical	fw
2     MeinPaket	ne:company
2     Melancholia	fw
2     Men	ne:company
2     Mh	inj
2     Micro	 fw; abbr
2     Mikro	dict
2     Mirko	ne:person
2     Mittweida	ne:geo
2     Mixtape	neologism
2     Montana	ne:person
2     MooTools	ne:product
2     Mose	ne:person
2     Motion	fw
2     Movie	fw
2     Munchen	 umlaut; ne:geo
2     Music	loan
2     Must	fw
2     Märktel.	token
2     NADA	
2     NDS	abbr
2     NEWAYS	ne:company
2     NHL	ne:company
2     NO	fw
2     Nabucco	ne:company
2     Nachrichte	
2     Nahles	ne:person
2     Nails	ne:company
2     Napster	ne:company
2     Nationalelf	compound
2     Navi	slang
2     Neckholder	ne:company
2     NegSmileyeria	
2     Nena	ne:person
2     Never	fw
2     Newman	ne:person
2     Newsletter	loan
2     Newsticker	loan
2     Ni	
2     Nice	fw
2     Nick	ne:person
2     Nicolas	ne:person
2     Nieblum	ne:geo
2     Niebüll	ne:geo
2     Niggemeier	ne:person
2     Nivea	ne:company
2     Noir	fw
2     Norman	ne:person
2     Nu	
2     Nuala	ne:person
2     Nudelfee	compound
2     OG	abbr
2     Occupy	
2     Ohja	inj
2     Olli	
2     Organizer	loan
2     Osnabrücker	ne:geo
2     Oststeinbek	ne:geo
2     Outfit	loan
2     PE	ne:person
2     PES	
2     PSN	
2     PUKY	ne:product
2     PVR	abbr
2     Pauli	 ne:person; ne:company
2     Peer	ne:person
2     Perlgarn	compound
2     Perro	ne:company
2     Perry	ne:person
2     Petry	ne:person
2     Pietro	ne:person
2     Pimp	fw
2     Ping	ne:product
2     Pinkelpause	compound
2     Pjanoo	fw
2     Pokemon	ne:person
2     Polish	fw
2     Polix	ne:product
2     Pollitz	ne:geo
2     Polo	dict
2     Polyester	dict
2     Ponyhof	compound
2     Popcorn	 dict; loan
2     Porn	 slang; fw
2     PosSmileyIch	
2     PosSmileyRT	
2     PosSmileyaniel	
2     PosSmileyie	
2     Potter	ne:person
2     ProSieben	
2     Probier	spell:probiere:deletion
2     Proclear	ne:product
2     Prof	 dict; abbr
2     Promifunk	
2     Prydz	ne:person
2     Prödl	ne:person
2     Pussy	 slang; fw
2     QT	hash_tag
2     QooQoon	ne:company
2     Quetschkalotten	compound
2     Quizfrage	compound
2     Quizspiel	compound
2     Quotes	fw
2     RIM	ne:company
2     RL	abbr
2     RNK	abbr
2     ROFL	abbr
2     RSC	abbr
2     RSS	neologism
2     Ra	fw
2     Rack	ne:product
2     Radolfzell	ne:geo
2     Raffhose	compound
2     Ramen	fw
2     Rammschutz	compound
2     Ranking	loan
2     Ratenkredit	compound
2     Ray	ne:person
2     Rayman	 ne:product; ne:person
2     Rea	ne:person
2     Reader	loan
2     Rees	ne:geo
2     Reflecta	ne:product
2     Reichensteuer	compound
2     Relaunch	loan
2     Remake	loan
2     Replay	loan
2     Reply	fw
2     Retweet	slang
2     Reunion	loan
2     Revelations	fw
2     Rhodan	ne:person
2     Rhon	ne:geo
2     Rica	ne:geo
2     Rida	ne:person
2     Rihanna	ne:person
2     Robertson	ne:person
2     Rofl	abbr
2     Ron	ne:person
2     Rosso	 ne:person; fw
2     Rotz	 slang; dict
2     Rousseff	ne:person
2     Row	ne:product
2     Royal	
2     Ruhrpott	ne:geo
2     Räikkönen	ne:person
2     Rösler	ne:person
2     Rübenberge	ne:geo
2     SALE	loan
2     SAT	ne:company
2     SEH	
2     SL	abbr
2     SM	abbr
2     SN	abbr
2     SSD	 neologism; abbr
2     ST	abbr
2     SUV	 neologism; abbr
2     SX	ne:product
2     Saarlouis	ne:geo
2     Sachsenring	ne:geo
2     Saints	ne:product
2     Sale	loan
2     Sami	ne:person
2     Sarvar	ne:geo
2     Scandlines	ne:company
2     Scenery	loan
2     Schatzchen	umlaut
2     Scheffler	ne:person
2     Schiri	slang
2     Schoki	slang
2     School	fw
2     Schortens	ne:geo
2     Schutzengelbilder	compound
2     Schwalbach	ne:geo
2     Scott	ne:person
2     Script	loan
2     Scrubs	 ne:product; fw
2     Scénic	ne:product
2     Sea	ne:geo
2     Second	fw
2     Sedo	
2     Series	fw
2     Setlur	ne:person
2     Sevelen	ne:company
2     Sexcam	loan
2     Seyfarth	ne:company
2     Shiply	ne:company
2     Shirts	loan
2     Shoppen	loan
2     Silent	
2     Simpson	ne:person
2     Skype	ne:product
2     Sleepers	
2     Smeet	ne:product
2     Smile	ne:product
2     Solingen	ne:geo
2     Somerhalder	ne:person
2     Songtext	
2     Sorgerecht	compound
2     Soso	inj
2     Sourcrowd	fw
2     SpOn	abbr
2     Specials	loan
2     Spencer	ne:person
2     Spielemagazin	compound
2     Std	abbr
2     Stendal	ne:geo
2     Sticks	loan
2     Stocker	ne:person
2     Stokke	ne:product
2     Stop	 inj; dict
2     Straks	 slang; spell:stracks:deletion
2     Street	
2     Subliminals	fw
2     Summinet	ne:company
2     Sunshine	fw
2     Superflat	
2     Supi	 slang; spell:super:substitution
2     Swingerparty	compound
2     Sync	slang
2     TBG	abbr
2     TERRARIUM	dict
2     TG	abbr
2     TIME	fw
2     TUV	umlaut
2     Tac	token
2     Tangled	ne:product
2     Tech	
2     TechniSat	ne:company
2     Teds	ne:person
2     Teen	loan
2     Th	spell:Thema:deletion
2     Thai	dict
2     Thank	 fw; inj
2     This	fw
2     Tic	inj
2     Tihi	inj
2     Tips	dict
2     Together	fw
2     Tokyo	ne:geo
2     Tollwood	ne:geo
2     Tonic	dict
2     Torsten	ne:person
2     Tr	spell:Trade:deletion
2     Track	loan
2     Tradigist	ne:geo
2     Trainee	fw
2     Traume	umlaut
2     Tripp	ne:product
2     Trudi	
2     Tschagajew	ne:person
2     Tv	abbr
2     Twittercharts	
2     UK	abbr
2     Uber	umlaut
2     Uckermann	ne:person
2     Uh	inj
2     Ulbig	ne:person
2     Uli	ne:person
2     Usher	ne:person
2     VIGNON	ne:product
2     VLC	
2     VOICE	fw
2     VRR	
2     Val	ne:person
2     Valentino	ne:person
2     Verden	
2     Very	fw
2     Vettel	ne:person
2     VfL	abbr
2     Victoria	
2     Vielzitzenmäuse	compound
2     Viersen	ne:geo
2     ViralUrl	ne:company
2     Vitelle	ne:product
2     Votze	slang
2     WH	abbr
2     WOW	inj
2     WZ	abbr
2     Wa	
2     Walk	loan
2     Wau	inj
2     Wave	fw
2     We	
2     Webcam	
2     Weicon	ne:product
2     Welcome	 fw; inj
2     Wels	dict
2     Wenns	
2     WettenDas	
2     What	fw
2     Who	
2     Why	fw
2     WiFi	 neologism; abbr
2     WikiLeaks	ne:company
2     Wilpert	ne:person
2     Win	
2     Windabweiser	dict
2     Wintec	ne:product
2     WippWalker	ne:product
2     Wissenschafter	spell:Wissenschaftler:deletion
2     Wohn	
2     WordPress	ne:product
2     World	fw
2     WpHG	abbr
2     Wuhu	inj
2     Wulff	ne:person
2     Wärmetauscher	compound
2     Wünsch	 slang; spell:wünsche:deletion
2     XXL	abbr
2     Xmas	 fw; slang
2     Xylitol	dict
2     YB	abbr
2     YOUR	fw
2     You	fw
2     Young	fw
2     Youporn	ne:company
2     Zillertal	ne:geo
2     Zuviel	
2     aba	 slang; spell:aber:substitution/deletion
2     abgesprengt	dict
2     abierta	ne:company
2     absicht	dict
2     achja	
2     adobe	
2     af	fw
2     afghanistan	
2     aha	inj
2     ahaha	inj
2     al	fw
2     alls	spell:alles:deletion
2     anfang	dict
2     ang	fw
2     anschluss	dict
2     anyone	fw
2     are	fw
2     argh	inj
2     artikel	dict
2     as	fw
2     auslosung	
2     ava	slang
2     awlb	
2     aynen	fw
2     backbord	dict
2     badminton	
2     bastel	 slang; spell:bastele:deletion
2     bauch	dict
2     bayreuth	ne:geo
2     bcruhr	
2     bday	 slang;  spell:birthday:deletion; fw
2     be	fw
2     befreuntet	spell:befreundet:deletion
2     beine	dict
2     berli	
2     beschä	spell:beschämen:deletion
2     best	fw
2     better	fw
2     bettwäsche	compound
2     beuel	
2     bieber	ne:person
2     biin	elongation
2     bilder	dict
2     bins	 slang; spell:bin es:deletion
2     boa	inj
2     bonn	
2     br	fw
2     bremen	
2     broo	fw
2     buchstaben	dict
2     button	loan
2     bäh	
2     ca	 dict; abbr
2     cam	 loan; abbr
2     campixx	
2     ccm	abbr
2     checken	loan
2     chillen	loan
2     cicero	
2     cih	spell:ich:substitution
2     club	loan
2     com	link
2     comSysto	ne:company
2     coolsten	loan
2     cro	
2     cyberport	loan
2     dallas	ne:geo
2     darfste	 slang; spell:darfst du:deletion
2     dd	abbr
2     debatte	dict
2     deluxe	ne:product
2     dennen	spell:denen:insertion
2     depri	 slang; spell:deprimiert:deletion
2     derStandardNewsroom	
2     dezember	
2     dialekt	dict
2     diamantiert	dict
2     dirk	ne:person
2     dissen	slang
2     diät	
2     dolle	 slang; spell:doll:insertion
2     download	loan
2     drum	 slang; spell:darum:deletion
2     duisburg	ne:geo
2     duu	elongation
2     döi	
2     eier	dict
2     eigentl.	abbr
2     ek	
2     electronic	fw
2     eltern	dict
2     email	neologism
2     entfolgt	neologism
2     eps	
2     erdkunde	dict
2     erinner	 slang; spell:erinnere:deletion
2     esch	 slang; spell:echt:insertion/deletion
2     esports	
2     etw	spell:etwas:deletion
2     ey.	inj
2     facepalm	
2     fands	 slang; spell:fand es:deletion
2     fang	 slang; spell:fange:insertion
2     fcbayern	
2     fck	
2     fcsp	
2     federball	
2     felixsturm	
2     fernsehprogramm	compound
2     feuerwehr	dict
2     fi	fw
2     fickmaul	slang
2     fine	spell:finde:deletion
2     first	fw
2     fm	
2     form	dict
2     fotos	dict
2     frauen	dict
2     freiemedien	
2     freitickets	 loan; compound
2     freude	dict
2     friedhöfe.	token
2     friends	fw
2     früherwarallesbesser	
2     funny	loan
2     fü	spell:für:deletion
2     games	fw
2     gay	neologism
2     ge	spell:gestern:deletion
2     gedanken	dict
2     geheimnis	dict
2     gelegenheit	dict
2     gepruft	umlaut
2     gerad	 slang; spell:gerade:deletion
2     geretweetet	neologism
2     german	fw
2     geschenke	dict
2     geschichte	dict
2     geschichtsträchtige	compound
2     geschri	spell:geschrieben:deletion
2     gewalt	
2     gewundert	dict
2     gg.	abbr
2     gibi	fw
2     gigaspeed	ne:product
2     git	 ne:product;  slang; spell:gibt:deletion
2     gladbach	ne:geo
2     glühwein	
2     gnaaa	inj
2     gold	dict
2     gone	fw
2     got	fw
2     grundeinkommen	
2     gruss	
2     grösse	
2     göttingen	
2     hahahaha	inj
2     hannah	ne:person
2     hass	dict
2     haun	 slang; spell:hauen:deletion
2     hauptsache	compound
2     have	fw
2     hdl	abbr
2     heey	inj
2     heidelberg	
2     heilbronn	ne:geo
2     heimat	
2     heise	ne:company
2     hihi	inj
2     ho	inj
2     hochgeladen.	token
2     hochzeit	dict
2     hoff	spell:hoffe:deletion
2     holland	ne:geo
2     holzfäller	
2     homepage	loan
2     homophoben	dict
2     hours	fw
2     html	
2     hund	dict
2     hut	fw
2     hälfte	dict
2     hätts	 slang; spell:hätte es:deletion
2     höhöhö	inj
2     ikea	ne:company
2     info	 abbr; dict
2     inner	spell:innere:deletion
2     itunes	ne:product
2     iwelche	 slang; spell:irgendwelche:deletion
2     jagger	ne:person
2     jahren	dict
2     jap	inj
2     jared	ne:person
2     jed	spell:jeder:deletion
2     jedermanns	dict
2     jedesmal	 slang; spell:jedes Mal:deletion
2     jena	
2     jmd	abbr
2     jmd.	abbr
2     joggen	
2     jtz	spell:jetzt:deletion
2     juhu	inj
2     jup	inj
2     kackt	dict
2     kalender	dict
2     kamel	dict
2     ke	spell:keinen:deletion
2     kinox	ne:company
2     klassiker	dict
2     klavier	dict
2     klimawandel	
2     kok	fw
2     kommentar	dict
2     kommis	
2     konzert	dict
2     kopfkratz	smiley
2     kostromanbieter	
2     kostromkosten	
2     kostrompreise	
2     krankenhaus	dict
2     kredit	
2     ksc	
2     kucken	 slang; spell:gucken:substitution
2     kulturzwitscher	
2     könn	
2     lala	slang
2     land	dict
2     langeweile	dict
2     laptop	neologism
2     laune	dict
2     ldkBB	
2     lebens	dict
2     lenksäulensteuergerät	compound
2     lenny	ne:person
2     let	fw
2     letzt	spell:letzten:deletion
2     leuten	dict
2     lisawolf	ne:person
2     loh	fw
2     losglück	
2     love	loan
2     low	fw
2     lsw	abbr
2     ludwigshafen	ne:geo
2     lünkern	slang
2     machts	 slang; spell:macht es:deletion
2     mak	fw
2     manno	inj
2     mas	fw
2     mate	ne:product
2     maus	dict
2     mcih	spell:mich:substitution
2     medien	
2     mega	dict
2     meh	inj
2     meister	dict
2     merci	 inj; fw
2     mim	fw
2     mind	abbr
2     minuten	dict
2     mist	 slang; dict
2     mitn	 slang; spell:mit einem:deletion
2     mittelstand	
2     ml	abbr
2     mmbe	
2     monate	dict
2     monaten	dict
2     montana	ne:person
2     more	fw
2     mousesports	ne:company
2     mund	dict
2     music	loan
2     musseinfachmalgesagtsein	
2     mädchen	
2     naar	fw
2     nachlegen	dict
2     nachmittag	dict
2     nachricht	dict
2     nachrichten	
2     nase	dict
2     natur	
2     naturgeile	dict
2     nazis	 slang; dict
2     nd	fw
2     nenn	 slang; spell:nenne:deletion
2     neuigkeiten	dict
2     niall	ne:person
2     nichtmehr	spell:nicht mehr:deletion
2     nit	spell:nicht:deletion
2     nix.	
2     nog	spell:noch:substitution
2     non	fw
2     not	 dict; fw
2     now	fw
2     nummer	dict
2     nürnberg	
2     oda	 slang; spell:oder:substitution/deletion
2     ohh	inj
2     ohje	inj
2     ok.	 token; inj
2     ordnung	dict
2     ots	abbr
2     ouml	fw
2     pacha	ne:geo
2     pack	 slang; spell:packe:deletion
2     papst	
2     park	dict
2     pech	dict
2     pinkelst	 slang; dict
2     pizza	dict
2     plan	dict
2     pls	 slang;  spell:please:deletion; fw
2     poldi	
2     pon	fw
2     port	 dict; loan
2     postet	neologism
2     posting	loan
2     proler	slang
2     prust	smiley
2     pöbeln	dict
2     rabatt	
2     random	fw
2     rathaus	dict
2     rbb	abbr
2     renn	 slang; spell:renne:deletion
2     reply	fw
2     rest	dict
2     rockt	loan
2     rotblaulive	
2     rs	abbr
2     rt	slang
2     sache	dict
2     sachen	dict
2     sale	loan
2     sami	ne:person
2     sat	ne:company
2     says	fw
2     schaft	spell:schafft:deletion
2     schalke	
2     schenk	 slang; spell:schenke:deletion
2     schenkenhttp	spell:schenken http:deletion
2     schlager	
2     schleime	dict
2     schliess	
2     schmeiss	
2     schnee	
2     schonwieder	spell:schon wieder:deletion
2     schweiz	dict
2     schweizer	dict
2     schwester	dict
2     seen	fw
2     sehn	 slang; spell:sehen:deletion
2     setz	 slang; spell:setze:deletion
2     si	fw
2     sidn	spell:sind:substitution
2     siehste	 slang; spell:siehst du:deletion,substitution
2     simulator	
2     sinn	dict
2     skichallenge	
2     skype	ne:product
2     skyrim	ne:product
2     sms	neologism
2     socialmedia	
2     sol	spell:solche:deletion
2     soldaten	
2     some	
2     spast	slang
2     spasti	slang
2     spontandemonstration	compound
2     sport	dict
2     ssnhd	
2     stalker	neologism
2     star	loan
2     staub	dict
2     std	abbr
2     stehn	 slang; spell:stehen:deletion
2     sten	token
2     story	 dict; loan
2     strip	 dict; loan
2     stuck	
2     studier	 slang; spell:studiere:deletion
2     stupa	
2     stylische	dict
2     suit	inj
2     supertalent	
2     svw	
2     szlig	fw
2     sänger	dict
2     sätze	dict
2     süd	
2     süüss	
2     tasche	dict
2     tau	fw
2     tee	dict
2     termin	dict
2     text	dict
2     than	fw
2     thanks.	
2     thedome	
2     therme	 loan; dict
2     thomas	
2     thumbs	fw
2     tisch	dict
2     tl	abbr
2     toi	inj
2     too	fw
2     trag	 slang; spell:trage:deletion
2     tresor	
2     ttms	
2     twannheim	
2     tweetet	neologism
2     tweetkalender	
2     twitterlauftreff	
2     twiät.	link
2     twuizzer	
2     twünchen	
2     typen	dict
2     tz	
2     tätschel	smiley
2     tür	dict
2     türchen	dict
2     ua	abbr
2     uber	umlaut
2     uch	inj
2     uh	inj
2     uhr.	token
2     umarm	 slang; spell:umarme:deletion
2     umarmung	dict
2     uni	
2     usb	neologism
2     uuh	inj
2     vaillant	ne:company
2     vergess	 slang; spell:vergesse:deletion
2     verpeilt	slang
2     verspätung	dict
2     versuchs	 slang; spell:versuche es:deletion
2     vid	abbr
2     video.	token
2     vids	 slang; spell:videos:deletion
2     vietnam	ne:geo
2     vll	abbr
2     vllt.	token
2     vorweihnachtszeit	compound
2     wahnsinn	dict
2     wech	
2     weekend	
2     wegn	spell:wegen:deletion
2     weihnachtsmarkt	compound
2     weilchen	dict
2     werbung	dict
2     wettendas	
2     wi	spell:wir:deletion
2     wiede	spell:wieder:deletion
2     wirtschaft	dict
2     wissenschaftl	spell:wissenschaftliche:deletion
2     woche.	token
2     wohn	
2     wolke	dict
2     worte	dict
2     ww	link
2     wärest.	token
2     xd	smiley
2     xmas	 fw; slang
2     yamaha	ne:product
2     yg	fw
2     your	fw
2     zB	abbr
2     zeiten	dict
2     zock	slang
2     zoll	dict
2     zuguckn	 slang; spell:zugucken:deletion
2     zw.	abbr
2     zwickau	
2     Ähm	
2     Ø	fw
2     ÜFA	
2     à	fw
2     änder	spell:ändern:deletion
2     öko	 dict; abbr
2     üb	fw
2     überleg	 slang; spell:überlege:deletion
2     ಠ	
